sgRNA Sequence	Target Gene Symbol
AAAAAAGCACCGCTCCTCAAG	ONE_INTERGENIC_SITE_1
AAAACCCCAATGTCACGTCTA	ONE_INTERGENIC_SITE_2
AAAACTATTAAACACCGATTA	ONE_INTERGENIC_SITE_3
AAAATAATGATAGTGCTCGTA	ONE_INTERGENIC_SITE_4
AAAATGCCCCATGAAACGGGC	ONE_INTERGENIC_SITE_5
AAAATGGAAACACGCCGGCTA	ONE_INTERGENIC_SITE_6
AAAATTTCCTCTCGTATGTAC	ONE_INTERGENIC_SITE_7
AAACAAAGAGCTACTCGGTAA	ONE_INTERGENIC_SITE_8
AAACAAGTGCTCCGACGCTTC	ONE_INTERGENIC_SITE_9
AAACATTCAGAGAAGCACCGT	ONE_INTERGENIC_SITE_10
AAACTAGGCACAGATTCGTAG	ONE_INTERGENIC_SITE_11
AAAGAAAATGCCCTGTCCCGA	ONE_INTERGENIC_SITE_12
AAAGATACTGCCCAGACGAGA	ONE_INTERGENIC_SITE_13
AAAGATCCTTACAGATCGTCA	ONE_INTERGENIC_SITE_14
AAAGCACAATTTAGGTATAGC	ONE_INTERGENIC_SITE_15
AAAGCCTGGACGATTATAGGT	ONE_INTERGENIC_SITE_16
AAAGGCAGGGCCTATACTATA	ONE_INTERGENIC_SITE_17
AAAGTACACCTGGGATGCGTC	ONE_INTERGENIC_SITE_18
AAAGTCTGCATAACGTCACTA	ONE_INTERGENIC_SITE_19
AAAGTTTAGAAAGCCTCGGAC	ONE_INTERGENIC_SITE_20
AAATAACTTCTTACTAGGACG	ONE_INTERGENIC_SITE_21
AAATATTAACAGTCCCGAACC	ONE_INTERGENIC_SITE_22
AAATCCCGGGTGTAATCGAGG	ONE_INTERGENIC_SITE_23
AAATTACGACTGCGTTTGCCC	ONE_INTERGENIC_SITE_24
AAATTTCAATCTTATCGTATG	ONE_INTERGENIC_SITE_25
AACAACCCATGATAAAGCGAG	ONE_INTERGENIC_SITE_26
AACACCGGCCATTATTGGTTA	ONE_INTERGENIC_SITE_27
AACACCTAATACCAATGCACC	ONE_INTERGENIC_SITE_28
AACATTAACGCTGATACACCG	ONE_INTERGENIC_SITE_29
AACCAAGATGTAGCCAGTTCG	ONE_INTERGENIC_SITE_30
AACCCCAGAATCAAGACCCGG	ONE_INTERGENIC_SITE_31
AACCCTATTCTCCGACTATGG	ONE_INTERGENIC_SITE_32
AACGCTCAGTTTAGGTCGAGA	ONE_INTERGENIC_SITE_33
AACTAATGAGGTCAAATCACG	ONE_INTERGENIC_SITE_34
AACTCAGCGAAGGACGGGTGC	ONE_INTERGENIC_SITE_35
AACTCTGCAAGGCTCCGATGG	ONE_INTERGENIC_SITE_36
AACTGTGGCGTTTCTCCGGAA	ONE_INTERGENIC_SITE_37
AAGAAACTACTGGATTAACGT	ONE_INTERGENIC_SITE_38
AAGAACTGGACCACACCCCAT	ONE_INTERGENIC_SITE_39
AAGAGACCAGAATTGTCGGGT	ONE_INTERGENIC_SITE_40
AAGAGCAGCAGATTCGAAGTC	ONE_INTERGENIC_SITE_41
AAGAGCCTACATAGGTCACCG	ONE_INTERGENIC_SITE_42
AAGAGCTCATCGTTGAGTAAC	ONE_INTERGENIC_SITE_43
AAGAGGTAATGATCGATTCAA	ONE_INTERGENIC_SITE_44
AAGAGTCAACGGAGTACACTC	ONE_INTERGENIC_SITE_45
AAGAGTCTAGAATACGGGCAC	ONE_INTERGENIC_SITE_46
AAGATCCAGACATGTCCGTTG	ONE_INTERGENIC_SITE_47
AAGATCTTTGTACCCCGATGG	ONE_INTERGENIC_SITE_48
AAGATGTTAATGGTTCGCCAT	ONE_INTERGENIC_SITE_49
AAGCCACGAGACTAGGTTGCC	ONE_INTERGENIC_SITE_50
AAGCCAGATCTCTGTCGCAAC	ONE_INTERGENIC_SITE_51
AAGCCATTACCGCCGGCGCGC	ONE_INTERGENIC_SITE_52
AAGCCGAGTGGGAAGGTCGAT	ONE_INTERGENIC_SITE_53
AAGCTCTTGCATCGGCAACCA	ONE_INTERGENIC_SITE_54
AAGCTTGGCACGATAGTACCT	ONE_INTERGENIC_SITE_55
AAGGAAATGAATTGGCCGATC	ONE_INTERGENIC_SITE_56
AAGGGCTACACATTCGCCCGT	ONE_INTERGENIC_SITE_57
AAGGTGGGGTTCTCCCGACCT	ONE_INTERGENIC_SITE_58
AAGTACTAGGGACTATGACCA	ONE_INTERGENIC_SITE_59
AAGTGAAATGCAGAACGCCAC	ONE_INTERGENIC_SITE_60
AAGTGTTCATTGACTGACCGA	ONE_INTERGENIC_SITE_61
AAGTTACAGCCTCCGAGCGAT	ONE_INTERGENIC_SITE_62
AATAAGACTACCGAATATAGG	ONE_INTERGENIC_SITE_63
AATAATATAACGTACGGGCAA	ONE_INTERGENIC_SITE_64
AATAGTAAGACTGTCGATCTA	ONE_INTERGENIC_SITE_65
AATATGATTCCACATACGATA	ONE_INTERGENIC_SITE_66
AATCTTAGGTGAAGTCGGTGA	ONE_INTERGENIC_SITE_67
AATGAAGCCTACCATCCATCG	ONE_INTERGENIC_SITE_68
AATGAGCTACAACTTAGACGG	ONE_INTERGENIC_SITE_69
AATGATAAGTCTATGGAGCGA	ONE_INTERGENIC_SITE_70
AATGATATCCAGTCTTGACGC	ONE_INTERGENIC_SITE_71
AATGATCACTAATGTCGGTGA	ONE_INTERGENIC_SITE_72
AATGATCGTGCCCTAGAGTAA	ONE_INTERGENIC_SITE_73
AATGCAGCAAATTTCAACGTG	ONE_INTERGENIC_SITE_74
AATGGCTGCAGAGGCGTGTAT	ONE_INTERGENIC_SITE_75
AATGGGTCTCCTAACACCTCG	ONE_INTERGENIC_SITE_76
AATGTTCTTATGGCATCACGT	ONE_INTERGENIC_SITE_77
AATTATTATGCGCTGACCTTA	ONE_INTERGENIC_SITE_78
ACAACTGCCAGGTGAACGCGA	ONE_INTERGENIC_SITE_79
ACAAGTACCGCAAGGTCGAAA	ONE_INTERGENIC_SITE_80
ACAATAGCTGGAGGGGTACGT	ONE_INTERGENIC_SITE_81
ACAATTAATGTATGGGGCCGT	ONE_INTERGENIC_SITE_82
ACACAGAGTTATGCAGCGAAT	ONE_INTERGENIC_SITE_83
ACACAGGGCAGCTACTCATCG	ONE_INTERGENIC_SITE_84
ACACCAAACTCACCGAGAGTA	ONE_INTERGENIC_SITE_85
ACACCGTTCCTACGGCGAACC	ONE_INTERGENIC_SITE_86
ACACCTATGAGAGTTTGAGCG	ONE_INTERGENIC_SITE_87
ACACGCCGGCTATAGAGCCAC	ONE_INTERGENIC_SITE_88
ACACGTCCTTAGAAGGACGTT	ONE_INTERGENIC_SITE_89
ACACGTCTGACGCAATTATCA	ONE_INTERGENIC_SITE_90
ACACTGACTACACGAATTCGT	ONE_INTERGENIC_SITE_91
ACACTGTACATTACCGAATAA	ONE_INTERGENIC_SITE_92
ACAGCAGGTTTGGACGAATTA	ONE_INTERGENIC_SITE_93
ACAGCGAAGTACAAGCATCGA	ONE_INTERGENIC_SITE_94
ACAGCTCGCAGACACACCGAG	ONE_INTERGENIC_SITE_95
ACAGGATTCAGTACTATCGAT	ONE_INTERGENIC_SITE_96
ACAGGCTGTGCTAGACGAGAG	ONE_INTERGENIC_SITE_97
ACAGTCATTCAAATCCATCGG	ONE_INTERGENIC_SITE_98
ACATATAAAGGGTCTCGTAGT	ONE_INTERGENIC_SITE_99
ACATGCCCCCCCTATGTCAAA	ONE_INTERGENIC_SITE_100
ACATGCGTCAAATATGTCGTG	ONE_INTERGENIC_SITE_101
ACATGGCGCAACAAATGTTAC	ONE_INTERGENIC_SITE_102
ACATGGGCCATTAACCCGGAG	ONE_INTERGENIC_SITE_103
ACCAACGCCCGGCACTCATTA	ONE_INTERGENIC_SITE_104
ACCAATCACTGACCGCGACCT	ONE_INTERGENIC_SITE_105
ACCACCACTCGACACTACTCT	ONE_INTERGENIC_SITE_106
ACCACTCACCTCCGGTGACGG	ONE_INTERGENIC_SITE_107
ACCAGATTGGTTGAATCAAAC	ONE_INTERGENIC_SITE_108
ACCATCAGCTATAAGAACCGC	ONE_INTERGENIC_SITE_109
ACCATTCTGGGCTATCGAGGT	ONE_INTERGENIC_SITE_110
ACCGAGCCAGCCTAATTACGA	ONE_INTERGENIC_SITE_111
ACCGGTTAGCAGATTATTGGC	ONE_INTERGENIC_SITE_112
ACCTAGACACGACTGTACTGG	ONE_INTERGENIC_SITE_113
ACCTAGGCAAGTGAGCATCGA	ONE_INTERGENIC_SITE_114
ACCTCCTAACCGCCTACCCAA	ONE_INTERGENIC_SITE_115
ACCTGGCTGCCGCCGAAACCG	ONE_INTERGENIC_SITE_116
ACCTGTGCTTACCGCGTCTTA	ONE_INTERGENIC_SITE_117
ACCTTGGGTTTCATATCGGTC	ONE_INTERGENIC_SITE_118
ACCTTTACCTCGGTCAGCCTA	ONE_INTERGENIC_SITE_119
ACGATGACAGTCCCGCGGCAA	ONE_INTERGENIC_SITE_120
ACGTGCGCAAAGGCGCACTCG	ONE_INTERGENIC_SITE_121
ACTAGCACTCCAATGAAACCG	ONE_INTERGENIC_SITE_122
ACTAGTTATCGTAGTACCGTA	ONE_INTERGENIC_SITE_123
ACTCCGTCACTAAGAACGCTT	ONE_INTERGENIC_SITE_124
ACTCTGAACATCCGCACTAAT	ONE_INTERGENIC_SITE_125
ACTGAGTCCAAATCTCCGTTA	ONE_INTERGENIC_SITE_126
ACTGCTTAACAAGGGGCGTAT	ONE_INTERGENIC_SITE_127
ACTGCTTCTACCGTACCTACG	ONE_INTERGENIC_SITE_128
ACTGGAGACTACTACATCACG	ONE_INTERGENIC_SITE_129
ACTTAAGGATTATCAACGAAT	ONE_INTERGENIC_SITE_130
ACTTAGCCGGATTGCTCCGTG	ONE_INTERGENIC_SITE_131
ACTTCACTGTGAACACGATCC	ONE_INTERGENIC_SITE_132
ACTTTCCCCGGATGCATAGTA	ONE_INTERGENIC_SITE_133
AGAAAATCTTAGTTGCCGTCA	ONE_INTERGENIC_SITE_134
AGAAAGGGGTTGGGCGTAACC	ONE_INTERGENIC_SITE_135
AGAACCAGTCGGACAGGTTGA	ONE_INTERGENIC_SITE_136
AGAACTGTAATACGTCTGGTG	ONE_INTERGENIC_SITE_137
AGAAGCGGCGAAAAAGTGCCG	ONE_INTERGENIC_SITE_138
AGAAGGGAATTGTTCTGACCG	ONE_INTERGENIC_SITE_139
AGAAGGTACCGTGATGCCACG	ONE_INTERGENIC_SITE_140
AGAATCTGTTGAGCCGCAGGA	ONE_INTERGENIC_SITE_141
AGACAATTGGGTAAACCTCCA	ONE_INTERGENIC_SITE_142
AGACACCCCCTAAACAGGCGT	ONE_INTERGENIC_SITE_143
AGACATCGTAATGTTACCCGC	ONE_INTERGENIC_SITE_144
AGACCACCTCTAGACAACACG	ONE_INTERGENIC_SITE_145
AGACCAGTGACTAATGGTCCG	ONE_INTERGENIC_SITE_146
AGACCCAAGTTAACCGCAACT	ONE_INTERGENIC_SITE_147
AGACTATCTATCAGGGGTTAC	ONE_INTERGENIC_SITE_148
AGACTGGGGATACCCCACGGA	ONE_INTERGENIC_SITE_149
AGAGAAATCTCAAACCCTCGA	ONE_INTERGENIC_SITE_150
AGAGACCAGCCTGAGGCATCG	ONE_INTERGENIC_SITE_151
AGAGAGGGATGACCTACGGAT	ONE_INTERGENIC_SITE_152
AGAGCCCACTCAGCACAACGG	ONE_INTERGENIC_SITE_153
AGAGCGTGCCGCCTGCACGCG	ONE_INTERGENIC_SITE_154
AGAGCTCAGAGTCCCGCATAA	ONE_INTERGENIC_SITE_155
AGAGGGAGGTCAATCTAGACG	ONE_INTERGENIC_SITE_156
AGAGTGTGGTGCTCGTAATAC	ONE_INTERGENIC_SITE_157
AGATAATCTTGCAAAGCGGGC	ONE_INTERGENIC_SITE_158
AGATAGTATAGGTACCCCACG	ONE_INTERGENIC_SITE_159
AGATCCACCCATAGAGGACGT	ONE_INTERGENIC_SITE_160
AGATGATGACCGTGCCGGCTC	ONE_INTERGENIC_SITE_161
AGATGCCATGAGTGCCGAATC	ONE_INTERGENIC_SITE_162
AGATGCTGGCGAATGACTATC	ONE_INTERGENIC_SITE_163
AGATTAGTCAGGAGTCGTGCA	ONE_INTERGENIC_SITE_164
AGCAAGCTGGGGCACCGCTAA	ONE_INTERGENIC_SITE_165
AGCAATAATCCAGCGTCATGA	ONE_INTERGENIC_SITE_166
AGCACTAAGTGCAACCTATCC	ONE_INTERGENIC_SITE_167
AGCAGACATCCTGACCACGTA	ONE_INTERGENIC_SITE_168
AGCAGCGCACGGTTAATGCTG	ONE_INTERGENIC_SITE_169
AGCAGTCACCGCAATTCCCAC	ONE_INTERGENIC_SITE_170
AGCATCGTATGTCTCAATTGC	ONE_INTERGENIC_SITE_171
AGCATGAGGGGTGAGCTCGCC	ONE_INTERGENIC_SITE_172
AGCCAAGGGGTTAAGCGACCT	ONE_INTERGENIC_SITE_173
AGCCGCCTGTAAAGAATCCCC	ONE_INTERGENIC_SITE_174
AGCCTCATTTGTGATAAGCGC	ONE_INTERGENIC_SITE_175
AGCCTCGCATCACAGCCCGCG	ONE_INTERGENIC_SITE_176
AGCCTGACTAGCCAAAACGGG	ONE_INTERGENIC_SITE_177
AGCGCCTCACGTGACCAAACG	ONE_INTERGENIC_SITE_178
AGCGGGGAGAACTCGACCGGG	ONE_INTERGENIC_SITE_179
AGCTATACTTAGTGCGCAAGA	ONE_INTERGENIC_SITE_180
AGCTATGGGAATCACCCCTTA	ONE_INTERGENIC_SITE_181
AGCTCTCTCGTATCCGAGTGG	ONE_INTERGENIC_SITE_182
AGGAACCATCCACCCGCTAAG	ONE_INTERGENIC_SITE_183
AGGACGTCCATTAAACGAGAG	ONE_INTERGENIC_SITE_184
AGGAGCTCCCCCTAACTCCGC	ONE_INTERGENIC_SITE_185
AGGAGGGAGCCAACTTTAACG	ONE_INTERGENIC_SITE_186
AGGATTACAAATCCCCGGATT	ONE_INTERGENIC_SITE_187
AGGCAGTTCATCGGTTAGAAC	ONE_INTERGENIC_SITE_188
AGGCGCCTACGATCCCATGCA	ONE_INTERGENIC_SITE_189
AGGCTAGTCTAGACTATACCG	ONE_INTERGENIC_SITE_190
AGGGATGGGTTGCCCGAATGT	ONE_INTERGENIC_SITE_191
AGGGTAGAATCGACTTGCTCA	ONE_INTERGENIC_SITE_192
AGGTGCCGTCCGGAGACCTTA	ONE_INTERGENIC_SITE_193
AGGTTACAACTTCTGATCCGT	ONE_INTERGENIC_SITE_194
AGGTTATTGATCGAGGGCCCA	ONE_INTERGENIC_SITE_195
AGTACCAGGAACAAACCGTCT	ONE_INTERGENIC_SITE_196
AGTAGATGCATTACATCAACG	ONE_INTERGENIC_SITE_197
AGTATGAGCATACAGGCGTAA	ONE_INTERGENIC_SITE_198
AGTCAAAGGTCAGAGCGTTCA	ONE_INTERGENIC_SITE_199
AGTCAAAGTGGACCGGTAGTT	ONE_INTERGENIC_SITE_200
AGTCAATCGGGGCCATCTAGG	ONE_INTERGENIC_SITE_201
AGTCAATGTATTAACACGCTG	ONE_INTERGENIC_SITE_202
AGTCACACGGGAGAATGCGTC	ONE_INTERGENIC_SITE_203
AGTCACCTTAACTGTGACACG	ONE_INTERGENIC_SITE_204
AGTCACTTAATGGGCGTCTAC	ONE_INTERGENIC_SITE_205
AGTCATGATGCTTTCCGCCTC	ONE_INTERGENIC_SITE_206
AGTCTGGAAAACGGGCTCGAA	ONE_INTERGENIC_SITE_207
AGTGCAGTCTCGCGATACTTC	ONE_INTERGENIC_SITE_208
AGTGTTGAGCTAACGACAGAT	ONE_INTERGENIC_SITE_209
AGTTCAAATATACCACGGGCT	ONE_INTERGENIC_SITE_210
AGTTCCGATGTCCAGCGAAGA	ONE_INTERGENIC_SITE_211
AGTTTATCACAACCAAACGCT	ONE_INTERGENIC_SITE_212
AGTTTGCGTGACCACTAAAGC	ONE_INTERGENIC_SITE_213
ATAAACCCGGTGCACGTTCAA	ONE_INTERGENIC_SITE_214
ATAAATAAAGATTCAGCGTCT	ONE_INTERGENIC_SITE_215
ATAACAACCGGACCATTAGGA	ONE_INTERGENIC_SITE_216
ATAACCTAAGAGCCTCCGCAG	ONE_INTERGENIC_SITE_217
ATAACGAATCCAGGACTCTAT	ONE_INTERGENIC_SITE_218
ATAACGGTATCCGCCTACTCT	ONE_INTERGENIC_SITE_219
ATAAGCTAATACAAATCGGTG	ONE_INTERGENIC_SITE_220
ATAATGTTCTACATTCTGCCG	ONE_INTERGENIC_SITE_221
ATACCAATAGTTCCCGGCTAA	ONE_INTERGENIC_SITE_222
ATACCACCCCTACACGACCTT	ONE_INTERGENIC_SITE_223
ATACTTACTTGCCGGGCGTTC	ONE_INTERGENIC_SITE_224
ATAGACACGCGTACCTGTTTC	ONE_INTERGENIC_SITE_225
ATAGAGGGGTCTCTCTACGAA	ONE_INTERGENIC_SITE_226
ATAGCATATATGTCTGCGACA	ONE_INTERGENIC_SITE_227
ATATAAAGAGCGTACGGAATT	ONE_INTERGENIC_SITE_228
ATATACTATCAACTCCTATAC	ONE_INTERGENIC_SITE_229
ATATTGGAATGAGTCGGAGCG	ONE_INTERGENIC_SITE_230
ATATTGGGTCCATAACGGGAG	ONE_INTERGENIC_SITE_231
ATCAGAGGATGATTAGCTCGT	ONE_INTERGENIC_SITE_232
ATCAGAGTTCAAGTGGGCCGA	ONE_INTERGENIC_SITE_233
ATCAGCCCAGCTCGCAATCGG	ONE_INTERGENIC_SITE_234
ATCATTAAGTTGACCCGTCCC	ONE_INTERGENIC_SITE_235
ATCCACCACTTCTGAATCGGT	ONE_INTERGENIC_SITE_236
ATCCACGCTCCTAACGATTGA	ONE_INTERGENIC_SITE_237
ATCCGTATCGACCTGTTATGT	ONE_INTERGENIC_SITE_238
ATCCGTTACATAACCCTCCCG	ONE_INTERGENIC_SITE_239
ATCCTTGTGAACGTCAACCAC	ONE_INTERGENIC_SITE_240
ATCGGAAAGTTGGCGGGACGT	ONE_INTERGENIC_SITE_241
ATCTGATAGCCCTGATAGACG	ONE_INTERGENIC_SITE_242
ATCTGGCAGTAGCCTTATATC	ONE_INTERGENIC_SITE_243
ATGAAATGCCACCATCCGGCA	ONE_INTERGENIC_SITE_244
ATGACATCTCCCTGGGCGACC	ONE_INTERGENIC_SITE_245
ATGACTGACCCAGCAGACACG	ONE_INTERGENIC_SITE_246
ATGAGAACCTGAATAAGGCGC	ONE_INTERGENIC_SITE_247
ATGAGGAATGTGCACGCACTA	ONE_INTERGENIC_SITE_248
ATGATGTCAAACCAGCGCGCA	ONE_INTERGENIC_SITE_249
ATGCAATGAGGGGTCGCCTTG	ONE_INTERGENIC_SITE_250
ATGCACTCCACAAGTTCGTGA	ONE_INTERGENIC_SITE_251
ATGCCAAAAGCCGTACTATGC	ONE_INTERGENIC_SITE_252
ATGCCGGACCGAATTCCTTGA	ONE_INTERGENIC_SITE_253
ATGCCGTACAACCGATCCTTA	ONE_INTERGENIC_SITE_254
ATGGCAAACCTCAACAGCGTA	ONE_INTERGENIC_SITE_255
ATGGCAGCCCAAACCCGCCAA	ONE_INTERGENIC_SITE_256
ATGGCGAGGTTAGATCTTCGT	ONE_INTERGENIC_SITE_257
ATGGCTCCATAAAAAACGTAC	ONE_INTERGENIC_SITE_258
ATGGGTGAGCATCACCCGTTA	ONE_INTERGENIC_SITE_259
ATGGTACTACCTAGCCGTGGT	ONE_INTERGENIC_SITE_260
ATGGTAGAGGACCCTGCTTCG	ONE_INTERGENIC_SITE_261
ATGGTGCCCTCAAGATTTACC	ONE_INTERGENIC_SITE_262
ATGTGGTTACCCGAGGGTTGA	ONE_INTERGENIC_SITE_263
ATGTTACTATAGGGGATCCAC	ONE_INTERGENIC_SITE_264
ATTCAGGACACCATTAACGAC	ONE_INTERGENIC_SITE_265
ATTCATCCCCTTGAACGTGCA	ONE_INTERGENIC_SITE_266
ATTCCAGCAAACGAATACCGA	ONE_INTERGENIC_SITE_267
ATTCCAGCCTTAAACGGAGCA	ONE_INTERGENIC_SITE_268
ATTCCCGAAGTGGCCGGGTCG	ONE_INTERGENIC_SITE_269
ATTCCTTTGTACAGCGCCACC	ONE_INTERGENIC_SITE_270
ATTCTCATAAATTTCCGTGGT	ONE_INTERGENIC_SITE_271
ATTCTCCTCTAACATCCCGTC	ONE_INTERGENIC_SITE_272
ATTCTGAAGCACTACGCCAAC	ONE_INTERGENIC_SITE_273
ATTGCGGGGCAATTATCCCGA	ONE_INTERGENIC_SITE_274
ATTGGTGATTCGCTACTACGA	ONE_INTERGENIC_SITE_275
ATTGTGTAACGCCCCCCATTT	ONE_INTERGENIC_SITE_276
ATTTGTCGCCCATACATCCGA	ONE_INTERGENIC_SITE_277
CAAAACCAGCCATCATACGAT	ONE_INTERGENIC_SITE_278
CAAACCCGGAGCCTCGAGACA	ONE_INTERGENIC_SITE_279
CAAAGACTTGCTAGGGTATCG	ONE_INTERGENIC_SITE_280
CAAATAAGGCCATAGTCCCGC	ONE_INTERGENIC_SITE_281
CAAATAATTCAAGTTCACTCG	ONE_INTERGENIC_SITE_282
CAACAACTGTTATATCACGGG	ONE_INTERGENIC_SITE_283
CAACCATCCAGTAAAAAACGT	ONE_INTERGENIC_SITE_284
CAACTTGGTATTACCGCCCTT	ONE_INTERGENIC_SITE_285
CAAGAGATCTGCCAGTCCGAA	ONE_INTERGENIC_SITE_286
CAAGAGGGATTGCCGGATATA	ONE_INTERGENIC_SITE_287
CAAGAGTGGTCCATCCACCGT	ONE_INTERGENIC_SITE_288
CAAGCTATGGGAGAACCTCGA	ONE_INTERGENIC_SITE_289
CAAGGCTCACGAAATACCCTT	ONE_INTERGENIC_SITE_290
CAAGGGTACTTAGAAACGTCC	ONE_INTERGENIC_SITE_291
CAAGTGTCACCAAGCGTAGAT	ONE_INTERGENIC_SITE_292
CAAGTGTGTACCTGACGGTAA	ONE_INTERGENIC_SITE_293
CAAGTTGGATCGGTCACTAAA	ONE_INTERGENIC_SITE_294
CAATATGTATTTATCGATTCG	ONE_INTERGENIC_SITE_295
CAATCAATGGCACTTACCTCG	ONE_INTERGENIC_SITE_296
CAATGGGGTGGGTCTAGGTCG	ONE_INTERGENIC_SITE_297
CAATTATCTTGCCAACGACAA	ONE_INTERGENIC_SITE_298
CAATTTCCCAGAACGATCTAT	ONE_INTERGENIC_SITE_299
CACAAATCGCGGGGACCTTCA	ONE_INTERGENIC_SITE_300
CACAAGATAGGATGGCCCCGC	ONE_INTERGENIC_SITE_301
CACACACAACCCCCGCGGTTT	ONE_INTERGENIC_SITE_302
CACACACACACGGCCTCAATA	ONE_INTERGENIC_SITE_303
CACACGCTCCGTTAATACGAT	ONE_INTERGENIC_SITE_304
CACACTAGCGTACTGGTTCTT	ONE_INTERGENIC_SITE_305
CACACTGCTTCTACCGTACCT	ONE_INTERGENIC_SITE_306
CACAGAGATGTCGACGCTTAA	ONE_INTERGENIC_SITE_307
CACAGATGCTGCGTAACACCT	ONE_INTERGENIC_SITE_308
CACAGGGCAGCTACTCATCGA	ONE_INTERGENIC_SITE_309
CACAGGGCCAATTAACGGAGC	ONE_INTERGENIC_SITE_310
CACATCCCATAACGATCAGAC	ONE_INTERGENIC_SITE_311
CACATCTGTGTCAAGCTGCGG	ONE_INTERGENIC_SITE_312
CACCAATTACTAATAGCGCCA	ONE_INTERGENIC_SITE_313
CACCTGGTCCACTAACCGGCT	ONE_INTERGENIC_SITE_314
CACTATGCGGGGCTCGGGACT	ONE_INTERGENIC_SITE_315
CACTCAAATATCACATCGGCA	ONE_INTERGENIC_SITE_316
CACTTCGTGATATCAGCACGC	ONE_INTERGENIC_SITE_317
CACTTGTCCTGTAATCGATTG	ONE_INTERGENIC_SITE_318
CAGAACTAGACATTCACCCGA	ONE_INTERGENIC_SITE_319
CAGAGGAGTGACAAATCACCG	ONE_INTERGENIC_SITE_320
CAGATGAATTACTCCTGCGGG	ONE_INTERGENIC_SITE_321
CAGCAAGATCCATGATACGAG	ONE_INTERGENIC_SITE_322
CAGCCAAGTGGGGACACGCGA	ONE_INTERGENIC_SITE_323
CAGCCACGGGTCCGATACTGA	ONE_INTERGENIC_SITE_324
CAGCCATTTCTGCCGATGAGC	ONE_INTERGENIC_SITE_325
CAGCCTCTACTATTCGAACCC	ONE_INTERGENIC_SITE_326
CAGCTGCCAGAATGGTGACGC	ONE_INTERGENIC_SITE_327
CAGGCCCTTATCGATAACATG	ONE_INTERGENIC_SITE_328
CAGGGACAGCCCTTCGCACCT	ONE_INTERGENIC_SITE_329
CAGTCCCATGTGGAGTACTCG	ONE_INTERGENIC_SITE_330
CAGTGCACCAATGCGCGATTG	ONE_INTERGENIC_SITE_331
CAGTTTATCGCCTAAACCAAC	ONE_INTERGENIC_SITE_332
CATAAACCATGACACGATAGC	ONE_INTERGENIC_SITE_333
CATAAATCCCTGAGCTAGACG	ONE_INTERGENIC_SITE_334
CATAGGGCTGGTGAACGACGG	ONE_INTERGENIC_SITE_335
CATAGGTGGGACACCGGTATC	ONE_INTERGENIC_SITE_336
CATCACTGGTCATATATACCG	ONE_INTERGENIC_SITE_337
CATCCACTTTCAACTATAACG	ONE_INTERGENIC_SITE_338
CATCGCCGTAGTTCACGAGCA	ONE_INTERGENIC_SITE_339
CATCTCTAGGTGATTAGACGA	ONE_INTERGENIC_SITE_340
CATGCATCTTGTTCGTGTTAT	ONE_INTERGENIC_SITE_341
CATGCATGCATTGGAATTCCG	ONE_INTERGENIC_SITE_342
CATGCCGGTTCATAATCCGAG	ONE_INTERGENIC_SITE_343
CATGCTAACTGTAGCGAATTG	ONE_INTERGENIC_SITE_344
CATGGACCGTGAGCGGATAGA	ONE_INTERGENIC_SITE_345
CATGGGTTAATTCGATTCCAT	ONE_INTERGENIC_SITE_346
CATGTAGTACAGCACATACGT	ONE_INTERGENIC_SITE_347
CATGTCCAGAGGCACCGATTT	ONE_INTERGENIC_SITE_348
CATGTGCAACAGTCGATATTA	ONE_INTERGENIC_SITE_349
CATTCATGGATACTACCACTA	ONE_INTERGENIC_SITE_350
CATTCCTGTGCTAGTACCTTG	ONE_INTERGENIC_SITE_351
CATTCTCAACGCCAAATCACA	ONE_INTERGENIC_SITE_352
CATTGGAGGGAGTACCACCGC	ONE_INTERGENIC_SITE_353
CATTTCGGTGGGGAGCCCGGA	ONE_INTERGENIC_SITE_354
CCAAAGTTCCCGCGATCACCC	ONE_INTERGENIC_SITE_355
CCAAGAGGGCAAACGAGCGGC	ONE_INTERGENIC_SITE_356
CCAAGGGAGGCAATGTACGAG	ONE_INTERGENIC_SITE_357
CCACCGCAGCGACAATCCGAA	ONE_INTERGENIC_SITE_358
CCACGAATTGGAATTACGTGA	ONE_INTERGENIC_SITE_359
CCAGAGAGTTACCGTAAGTTA	ONE_INTERGENIC_SITE_360
CCAGAGTGCACCTACAAACGA	ONE_INTERGENIC_SITE_361
CCAGCACCAGACGCCTTACTC	ONE_INTERGENIC_SITE_362
CCAGGAATAAATTCCCGCGGA	ONE_INTERGENIC_SITE_363
CCAGTTCTCCAATTAACCAAG	ONE_INTERGENIC_SITE_364
CCATAACTGTACACCCACGAT	ONE_INTERGENIC_SITE_365
CCATATGTCAGTCTGGCGATC	ONE_INTERGENIC_SITE_366
CCATCAGATCTACATTGCCGT	ONE_INTERGENIC_SITE_367
CCATTGAAACCACCGAACCGT	ONE_INTERGENIC_SITE_368
CCCACAAACATAGCGACGTGT	ONE_INTERGENIC_SITE_369
CCCACCGAATTATTCCCCACC	ONE_INTERGENIC_SITE_370
CCCCAGGCAGCCACTATCCGT	ONE_INTERGENIC_SITE_371
CCCCAGTTCTGGGGCTCGCCA	ONE_INTERGENIC_SITE_372
CCCCCGTGCCGTCCCTCACGG	ONE_INTERGENIC_SITE_373
CCCCGAACCACACTCGGGTGG	ONE_INTERGENIC_SITE_374
CCCTCCTTTCCGGGCCGTTTA	ONE_INTERGENIC_SITE_375
CCCTGGCTCCGGGCAACAATA	ONE_INTERGENIC_SITE_376
CCCTGTGAGCTATGTACGCTT	ONE_INTERGENIC_SITE_377
CCGACTTTGCATCACCGAAGC	ONE_INTERGENIC_SITE_378
CCGATCTTACGGGCATGCACG	ONE_INTERGENIC_SITE_379
CCGCGAGATAATGATTGATCG	ONE_INTERGENIC_SITE_380
CCGCTGTAAAGATCTATCGTC	ONE_INTERGENIC_SITE_381
CCTAAGCACTCATCCCGCACT	ONE_INTERGENIC_SITE_382
CCTAAGTGTCAAGTAACGGGC	ONE_INTERGENIC_SITE_383
CCTATCAGCCCAGCTCGCAAT	ONE_INTERGENIC_SITE_384
CCTATGAATGCGCCCATCACG	ONE_INTERGENIC_SITE_385
CCTCCCGTGGTTGACGTTCAC	ONE_INTERGENIC_SITE_386
CCTCTTCGCACAAGCTCGGAA	ONE_INTERGENIC_SITE_387
CCTGCGGTTCACCAGACTATG	ONE_INTERGENIC_SITE_388
CCTGGGGAGTTAAAATTGCGT	ONE_INTERGENIC_SITE_389
CCTGTAATGCCACGTACTTGA	ONE_INTERGENIC_SITE_390
CCTTATCCTTGGTCCCGCTCA	ONE_INTERGENIC_SITE_391
CCTTCACCCAATGCCCTAGTC	ONE_INTERGENIC_SITE_392
CCTTCACTGGTGGTTAGCGCC	ONE_INTERGENIC_SITE_393
CCTTCTATCCCAGCCCGAATG	ONE_INTERGENIC_SITE_394
CCTTGATGGACCAACCGCACT	ONE_INTERGENIC_SITE_395
CCTTGCAACCATACCCCGGAG	ONE_INTERGENIC_SITE_396
CCTTTAACTAGTAGTACGAGC	ONE_INTERGENIC_SITE_397
CGAGAGCATCCAGACCGGTCC	ONE_INTERGENIC_SITE_398
CGAGCAAGAGCAGACGACGAC	ONE_INTERGENIC_SITE_399
CGATGGCACCCCAATTCACTA	ONE_INTERGENIC_SITE_400
CGCAACTTGGGAGCGCCCGCC	ONE_INTERGENIC_SITE_401
CGCGGCGACTGGCAGACGAGC	ONE_INTERGENIC_SITE_402
CGGCAAGTCCAGAACACCGGG	ONE_INTERGENIC_SITE_403
CGGTAACCATTAACTTCCTCG	ONE_INTERGENIC_SITE_404
CGTATAGGACGCGAAATCGAA	ONE_INTERGENIC_SITE_405
CGTCCAGTTCCAAGGTCCACG	ONE_INTERGENIC_SITE_406
CGTCGAAATAGCCTAGGACGA	ONE_INTERGENIC_SITE_407
CGTGACCACTAAAGCCGGGGT	ONE_INTERGENIC_SITE_408
CGTTCCCTGGGTAACCACGAC	ONE_INTERGENIC_SITE_409
CTAAATCAGCCGATGTACTCC	ONE_INTERGENIC_SITE_410
CTAAGCATGCTGAACGCCATT	ONE_INTERGENIC_SITE_411
CTACTAGATAGTGTCGTCTAG	ONE_INTERGENIC_SITE_412
CTAGAAAATTTGGGTCTAACG	ONE_INTERGENIC_SITE_413
CTAGACGCAAAGTACACAACG	ONE_INTERGENIC_SITE_414
CTAGCACCTATTGGATCAGTC	ONE_INTERGENIC_SITE_415
CTAGGTTATACCCAATTCGAA	ONE_INTERGENIC_SITE_416
CTATCTGCATCCCCACGACTC	ONE_INTERGENIC_SITE_417
CTATTGCCAGGCCGAGTAATC	ONE_INTERGENIC_SITE_418
CTCAATAGTAGCCTTTCGACC	ONE_INTERGENIC_SITE_419
CTCACAGGCTCTTAGCGCTAA	ONE_INTERGENIC_SITE_420
CTCAGGCCGGCAAATATACCC	ONE_INTERGENIC_SITE_421
CTCAGTGTCAGTCGCTCGAGT	ONE_INTERGENIC_SITE_422
CTCATCCTGTTAATAACGCCA	ONE_INTERGENIC_SITE_423
CTCCACCCAGCCTCTTCGGCG	ONE_INTERGENIC_SITE_424
CTCCAGGAAGATCCCTCGACT	ONE_INTERGENIC_SITE_425
CTCCCACAAACATAGCGACGT	ONE_INTERGENIC_SITE_426
CTCCCAGCATGGTAGTAACGG	ONE_INTERGENIC_SITE_427
CTCCCTAGAGAGACATTCGTA	ONE_INTERGENIC_SITE_428
CTCCGCCTCGTAACAGTCATA	ONE_INTERGENIC_SITE_429
CTCCTGCACTCATGCTCGACC	ONE_INTERGENIC_SITE_430
CTCCTTTAGTCACGTACCCTC	ONE_INTERGENIC_SITE_431
CTCTATACCCCGACTTTCACG	ONE_INTERGENIC_SITE_432
CTCTGAGAAGTCGAGAGCGAA	ONE_INTERGENIC_SITE_433
CTCTGAGCACCCCGTGGCCGG	ONE_INTERGENIC_SITE_434
CTCTTGTCTACGGGGATTGTA	ONE_INTERGENIC_SITE_435
CTGAAATCCATTTACCCGTGA	ONE_INTERGENIC_SITE_436
CTGACGGTCTGAGCTCGATAG	ONE_INTERGENIC_SITE_437
CTGAGCCCCTGAGTGCGAGCT	ONE_INTERGENIC_SITE_438
CTGCAATGGAGAATCTCGTTC	ONE_INTERGENIC_SITE_439
CTGCAATGTCCGCTTCTGCGA	ONE_INTERGENIC_SITE_440
CTGCAGACTGTCAGTGCGTAT	ONE_INTERGENIC_SITE_441
CTGCCACGAAGCGAACCAACT	ONE_INTERGENIC_SITE_442
CTGCCTCCCGAGCCTGCTTAA	ONE_INTERGENIC_SITE_443
CTGCTATCATCGAATCTACTG	ONE_INTERGENIC_SITE_444
CTGGAGCAGCTGTCGTGCGCA	ONE_INTERGENIC_SITE_445
CTGGCCCCTATCACGGTATAA	ONE_INTERGENIC_SITE_446
CTGGCGACAGACGTGAATAGC	ONE_INTERGENIC_SITE_447
CTGGGTATCCATTCCCCCTAA	ONE_INTERGENIC_SITE_448
CTGTCTCCCACGTGTTCGCTT	ONE_INTERGENIC_SITE_449
CTGTCTGTGATTAACTTCCCG	ONE_INTERGENIC_SITE_450
CTGTGCAAACTACTGGGGTCG	ONE_INTERGENIC_SITE_451
CTGTGGTACGAACCTCCATAT	ONE_INTERGENIC_SITE_452
CTGTGTGGCTAACGTTAACGA	ONE_INTERGENIC_SITE_453
CTTAAGAACCAGTACGCTAGT	ONE_INTERGENIC_SITE_454
CTTAATGCTACCGATTGTCCC	ONE_INTERGENIC_SITE_455
CTTACTAGCTAGTCACGATGC	ONE_INTERGENIC_SITE_456
CTTACTGATAAATCCTCCCGC	ONE_INTERGENIC_SITE_457
CTTCAAGAGCCCCCGCCGATG	ONE_INTERGENIC_SITE_458
CTTCCAATTAGTTAACGTCAC	ONE_INTERGENIC_SITE_459
CTTCGGAATGATTATAACGAA	ONE_INTERGENIC_SITE_460
CTTCTATCCCAGCCCGAATGC	ONE_INTERGENIC_SITE_461
CTTCTTAAAGGCCGTCAGTTC	ONE_INTERGENIC_SITE_462
CTTGAGATCATGGGTATCTCG	ONE_INTERGENIC_SITE_463
CTTGATAAACAACATGTCTCG	ONE_INTERGENIC_SITE_464
CTTGCTCACGCATAGTGCGTC	ONE_INTERGENIC_SITE_465
CTTGGCTGTGTGAAGCGCTAA	ONE_INTERGENIC_SITE_466
CTTGTAGGAAACCATCGTATA	ONE_INTERGENIC_SITE_467
CTTGTTCCTCTCTGGCGAAAC	ONE_INTERGENIC_SITE_468
CTTTACAGCTGTTCATCGGTC	ONE_INTERGENIC_SITE_469
CTTTGTAACACAGATACCCCG	ONE_INTERGENIC_SITE_470
CTTTGTTCACTAACTAGCCGA	ONE_INTERGENIC_SITE_471
GAAAATTCTCAAACCGGCCCA	ONE_INTERGENIC_SITE_472
GAAACATTCCCGTCACGTCAC	ONE_INTERGENIC_SITE_473
GAAACCACAACCAATCACCCG	ONE_INTERGENIC_SITE_474
GAAAGCGGGTAAGAGTCGTGC	ONE_INTERGENIC_SITE_475
GAAAGTGTAGATCGCACCCCG	ONE_INTERGENIC_SITE_476
GAAATAGGCCAACAATCATGC	ONE_INTERGENIC_SITE_477
GAAATGGAGACAGTTCATACG	ONE_INTERGENIC_SITE_478
GAACAAGAAACTTCCGCCAAC	ONE_INTERGENIC_SITE_479
GAACACTCACCGAAAGCGATG	ONE_INTERGENIC_SITE_480
GAACCAACTACCTGAGCCCGC	ONE_INTERGENIC_SITE_481
GAACCTTCACGTAGGCCGGCA	ONE_INTERGENIC_SITE_482
GAACTACTGGACTGGACTCGA	ONE_INTERGENIC_SITE_483
GAACTCAGTTGGTCTCCACGA	ONE_INTERGENIC_SITE_484
GAACTCGAGCTGCCGCGATGC	ONE_INTERGENIC_SITE_485
GAAGAGTTCGCGGCGATCAGA	ONE_INTERGENIC_SITE_486
GAAGCACTCAAATCCGTAATA	ONE_INTERGENIC_SITE_487
GAAGCTAACCAATCAAGACGC	ONE_INTERGENIC_SITE_488
GAAGGGCGGTAATACCAAGTT	ONE_INTERGENIC_SITE_489
GAAGGTTCAGGACATAACCGT	ONE_INTERGENIC_SITE_490
GAAGTCTCTCCCCATGCCCGG	ONE_INTERGENIC_SITE_491
GAAGTTACAGCCTCCGAGCGA	ONE_INTERGENIC_SITE_492
GAATACATAGTGTAGTCGTGT	ONE_INTERGENIC_SITE_493
GAATGAGTCACTCGGGCGGGC	ONE_INTERGENIC_SITE_494
GAATTATTTGGTACCGCACAT	ONE_INTERGENIC_SITE_495
GACAAGTGGCCAAACGGATAA	ONE_INTERGENIC_SITE_496
GACAGAGTTTAAGCCTCGAAC	ONE_INTERGENIC_SITE_497
GACAGGGGCAAATCACCTCGT	ONE_INTERGENIC_SITE_498
GACAGTCAGTATGTTCACGAA	ONE_INTERGENIC_SITE_499
GACATCAAACTAGTGGCGGAT	ONE_INTERGENIC_SITE_500
GACCACGGCGTAGACTTGCAG	ONE_INTERGENIC_SITE_501
GACCATGAAATGCACCCCCTA	ONE_INTERGENIC_SITE_502
GACCGCCCCATAGATATTAGA	ONE_INTERGENIC_SITE_503
GACCGGGTCAGAAATCCTCGT	ONE_INTERGENIC_SITE_504
GACCTACTGGGAGCAATTACC	ONE_INTERGENIC_SITE_505
GACCTCCACGGTGCGTAATGC	ONE_INTERGENIC_SITE_506
GACCTGTCACCGTCGATGTAA	ONE_INTERGENIC_SITE_507
GACCTTTACTGCATGCCTCGC	ONE_INTERGENIC_SITE_508
GACGCGGTCCAGCACTCCCCG	ONE_INTERGENIC_SITE_509
GACGCGTCCGACCACTCGTGC	ONE_INTERGENIC_SITE_510
GACGCTGACCAGGTCGGCGCA	ONE_INTERGENIC_SITE_511
GACTCATGGATAGTCGAAACA	ONE_INTERGENIC_SITE_512
GACTCCTCAGCATTATAACCG	ONE_INTERGENIC_SITE_513
GACTGTCGGCTTTCCCGACAG	ONE_INTERGENIC_SITE_514
GAGAACTGAAAGGATCCGAGC	ONE_INTERGENIC_SITE_515
GAGAAGCCAACAGCTTCCACG	ONE_INTERGENIC_SITE_516
GAGAAGCGGCGAAAAAGTGCC	ONE_INTERGENIC_SITE_517
GAGAATGGGGTTGGTTCACGG	ONE_INTERGENIC_SITE_518
GAGACAAAGCATACACTACGA	ONE_INTERGENIC_SITE_519
GAGAGATTTAGGGGGCGACAC	ONE_INTERGENIC_SITE_520
GAGAGCACTTTGCAAAATCGC	ONE_INTERGENIC_SITE_521
GAGATGCCATGAGTGCCGAAT	ONE_INTERGENIC_SITE_522
GAGATTCAGTCAATGACGTCC	ONE_INTERGENIC_SITE_523
GAGATTGGCCTATCTCGCCTC	ONE_INTERGENIC_SITE_524
GAGCATACGATGCTAACGGGG	ONE_INTERGENIC_SITE_525
GAGCCTAAGTTAGTCGAATCC	ONE_INTERGENIC_SITE_526
GAGGACGACTGTGGCTAATAC	ONE_INTERGENIC_SITE_527
GAGGATGTGCTCGCCCCCATA	ONE_INTERGENIC_SITE_528
GAGGCATCGAGGGTGTTCGAA	ONE_INTERGENIC_SITE_529
GAGGCCCTACTCAGATCGGAC	ONE_INTERGENIC_SITE_530
GAGGCGAAACAATGCGGAACC	ONE_INTERGENIC_SITE_531
GAGGTAGGATACTCAATGATC	ONE_INTERGENIC_SITE_532
GAGGTGCCGGCCCAATGTTAG	ONE_INTERGENIC_SITE_533
GAGTCCTGACCTTACGCAAGT	ONE_INTERGENIC_SITE_534
GAGTGGGGCAATACGATACAA	ONE_INTERGENIC_SITE_535
GAGTGTGGGCATAGACGGGGC	ONE_INTERGENIC_SITE_536
GAGTTAACTTAGCTGCCGACA	ONE_INTERGENIC_SITE_537
GAGTTGATGTTAGCTCGCCAG	ONE_INTERGENIC_SITE_538
GAGTTGTTAGCCAACGGCTGT	ONE_INTERGENIC_SITE_539
GATAAGAATTCTTATCTCCGG	ONE_INTERGENIC_SITE_540
GATACAGTTAAAGACCCGGAC	ONE_INTERGENIC_SITE_541
GATAGCAATTAATACGGTCTA	ONE_INTERGENIC_SITE_542
GATATTTGGCGAAACCGTATT	ONE_INTERGENIC_SITE_543
GATCAAAACGCACACAAATCG	ONE_INTERGENIC_SITE_544
GATCCCCATTCCGGCCGCAAA	ONE_INTERGENIC_SITE_545
GATCGCGAAAACCAGACGACT	ONE_INTERGENIC_SITE_546
GATGAAGTGTAACCTCCGAGA	ONE_INTERGENIC_SITE_547
GATGACTCCCGACACCCTAGC	ONE_INTERGENIC_SITE_548
GATGGAAACTCGTCACGTGTC	ONE_INTERGENIC_SITE_549
GATGGGCGATGCCTCATCGAT	ONE_INTERGENIC_SITE_550
GATGTTCAGGATGACGTTCGC	ONE_INTERGENIC_SITE_551
GATTACGACACGCGAATTCTT	ONE_INTERGENIC_SITE_552
GATTCTCAGAGTGAACCGGGT	ONE_INTERGENIC_SITE_553
GATTTGTTATAGTATGCGATG	ONE_INTERGENIC_SITE_554
GCAAACAGCCCACAGTAGCGC	ONE_INTERGENIC_SITE_555
GCACATCCGGAGGATGCTTCG	ONE_INTERGENIC_SITE_556
GCACTAGCAGGGTTACCGATA	ONE_INTERGENIC_SITE_557
GCACTGAAGGGTTATCGTCCT	ONE_INTERGENIC_SITE_558
GCACTGGCACGTAGTTAACTC	ONE_INTERGENIC_SITE_559
GCACTTTACAGTTCACGCTTC	ONE_INTERGENIC_SITE_560
GCAGAATTACATACGCTGGTA	ONE_INTERGENIC_SITE_561
GCAGAGCCCCGGGACTCGCCA	ONE_INTERGENIC_SITE_562
GCAGAGGGATCAATATGGCGG	ONE_INTERGENIC_SITE_563
GCAGTGCCGCCCTAATGGAAT	ONE_INTERGENIC_SITE_564
GCAGTTCTCCTGGACGCTTAA	ONE_INTERGENIC_SITE_565
GCAGTTGTGGGCCTTAGTCGG	ONE_INTERGENIC_SITE_566
GCAGTTTGGAGTGAGCGATTA	ONE_INTERGENIC_SITE_567
GCATACCCCTAGACACTCGAA	ONE_INTERGENIC_SITE_568
GCATATGATTAAGAGGTACGC	ONE_INTERGENIC_SITE_569
GCATCTCGTTACGTCTTGCTG	ONE_INTERGENIC_SITE_570
GCATCTTTATATTGATTCGAT	ONE_INTERGENIC_SITE_571
GCATTCGAGAGTTCGTCGTAC	ONE_INTERGENIC_SITE_572
GCATTTACACCTTAATACGCA	ONE_INTERGENIC_SITE_573
GCCACCTACCCTGACGATACA	ONE_INTERGENIC_SITE_574
GCCAGCTCCCCTCGACCATGA	ONE_INTERGENIC_SITE_575
GCCATAACAAGGGAAACCCGC	ONE_INTERGENIC_SITE_576
GCCCAAGGAAGGACGCGCTTC	ONE_INTERGENIC_SITE_577
GCCCCTATTAGCCGCTTATTA	ONE_INTERGENIC_SITE_578
GCCCGGGTGCAAACACAACTA	ONE_INTERGENIC_SITE_579
GCCGACTGTGTGCACCGCGTT	ONE_INTERGENIC_SITE_580
GCCTAAGCCGTGTCTGTACGG	ONE_INTERGENIC_SITE_581
GCCTCAACACGAGAATCGCCC	ONE_INTERGENIC_SITE_582
GCCTCCGTCAACAACCAAAGT	ONE_INTERGENIC_SITE_583
GCCTGAGACAAACAGTCGTGA	ONE_INTERGENIC_SITE_584
GCGACCGATTCCGTGGACAGA	ONE_INTERGENIC_SITE_585
GCGAGAATAACGAGTTGTGCC	ONE_INTERGENIC_SITE_586
GCGAGTACCCGCCCGTACCAA	ONE_INTERGENIC_SITE_587
GCGGTGCACCCACATTGCCGC	ONE_INTERGENIC_SITE_588
GCGGTTCGCCGTAGGAACGGT	ONE_INTERGENIC_SITE_589
GCTCAAAATATGAGGTCCCGA	ONE_INTERGENIC_SITE_590
GCTCCACACCTTGACGCCCTT	ONE_INTERGENIC_SITE_591
GCTCCCCCGATAGCCCCACGC	ONE_INTERGENIC_SITE_592
GCTCGAGTTCGGGAGTCACCC	ONE_INTERGENIC_SITE_593
GCTCTAAGGTGCATGCACCCG	ONE_INTERGENIC_SITE_594
GCTCTCTCAGGCGTCACGAAA	ONE_INTERGENIC_SITE_595
GCTGAATTGTTAAAGCCCGGT	ONE_INTERGENIC_SITE_596
GCTGACCCCCGTTGTCTTGAT	ONE_INTERGENIC_SITE_597
GCTGACGGCCAAGAGGCACCG	ONE_INTERGENIC_SITE_598
GCTGAGTCCTTTGCATCGCGC	ONE_INTERGENIC_SITE_599
GCTGAGTTAAGAGGGTACCCG	ONE_INTERGENIC_SITE_600
GCTGCCGCTCAAGAGCACGCG	ONE_INTERGENIC_SITE_601
GCTGCTACAGCTCTATCTCGG	ONE_INTERGENIC_SITE_602
GCTGCTATGACATGTGTACGG	ONE_INTERGENIC_SITE_603
GCTGGCAACCGAGTTATAATA	ONE_INTERGENIC_SITE_604
GCTGGCACTTATACTAGACCC	ONE_INTERGENIC_SITE_605
GCTGTATTATTAGCTCTGTCG	ONE_INTERGENIC_SITE_606
GCTGTGTCTATATGATCGTGA	ONE_INTERGENIC_SITE_607
GCTGTTACTAACCACCGGAGC	ONE_INTERGENIC_SITE_608
GCTTCATACCGAGAACGCAAA	ONE_INTERGENIC_SITE_609
GCTTCCCGATTCTAGATTGAG	ONE_INTERGENIC_SITE_610
GCTTCTCAAGCCAGCCTACGG	ONE_INTERGENIC_SITE_611
GCTTTCAAAGATCCGTCATGT	ONE_INTERGENIC_SITE_612
GCTTTCCTGGTACGTCCATAG	ONE_INTERGENIC_SITE_613
GCTTTCTGACCAGTTTAACGT	ONE_INTERGENIC_SITE_614
GGAAATATACGATCTAACCCC	ONE_INTERGENIC_SITE_615
GGAAATTCCACCCCCCGCAGG	ONE_INTERGENIC_SITE_616
GGAAATTTCTTCCGTTCCGAA	ONE_INTERGENIC_SITE_617
GGAAGCTTGATGGGAACCTCC	ONE_INTERGENIC_SITE_618
GGAATTCCGGGAATTCGCTAG	ONE_INTERGENIC_SITE_619
GGACAATGAACCTCAGGCACG	ONE_INTERGENIC_SITE_620
GGACCTCGTCACTGATTACGG	ONE_INTERGENIC_SITE_621
GGAGAGAACATCATCGGCCAA	ONE_INTERGENIC_SITE_622
GGAGATAACCCAGTTTCCGAA	ONE_INTERGENIC_SITE_623
GGAGGAGACCGACTCCCCTGA	ONE_INTERGENIC_SITE_624
GGAGGGGCTTGTAATGCAACG	ONE_INTERGENIC_SITE_625
GGAGTTTAAAGTAGGCGGCTC	ONE_INTERGENIC_SITE_626
GGATTCGCGGGAATCGTCTGC	ONE_INTERGENIC_SITE_627
GGCAATTATCCCGACGGAGTT	ONE_INTERGENIC_SITE_628
GGCACATGGTCAGGCCAGACG	ONE_INTERGENIC_SITE_629
GGCAGCAGCAAGGTAATCGAC	ONE_INTERGENIC_SITE_630
GGCCGCAGAAGCTACCGAACC	ONE_INTERGENIC_SITE_631
GGCCTCTGTGAGATAGCCGAG	ONE_INTERGENIC_SITE_632
GGCTAGCTGACCAACAATCGA	ONE_INTERGENIC_SITE_633
GGCTCCCAAGGACGTAGCCTA	ONE_INTERGENIC_SITE_634
GGCTCGGGCAACAACCACTAT	ONE_INTERGENIC_SITE_635
GGCTGCTCTCCAACGAGAACC	ONE_INTERGENIC_SITE_636
GGGAACTGAGAAAGTCCCGGT	ONE_INTERGENIC_SITE_637
GGGAAGTGCCGCTCCGTAAAG	ONE_INTERGENIC_SITE_638
GGGACCAAAGAGAGCGGCGAA	ONE_INTERGENIC_SITE_639
GGGAGGGGTGTTAGTTTGCGA	ONE_INTERGENIC_SITE_640
GGGATCAAAAGGTCGGTCGGG	ONE_INTERGENIC_SITE_641
GGGCACCAACGATCACGAGAT	ONE_INTERGENIC_SITE_642
GGGGAGCTGGAAACTTATCGC	ONE_INTERGENIC_SITE_643
GGGGGACAGGCTACCGCCAAC	ONE_INTERGENIC_SITE_644
GGGGTCATCATGCAACGGTCA	ONE_INTERGENIC_SITE_645
GGGGTGGCCTAAAATCGTTCT	ONE_INTERGENIC_SITE_646
GGGTATCCGCTATGTACCACT	ONE_INTERGENIC_SITE_647
GGGTATTAGTCCCCCTGCTAG	ONE_INTERGENIC_SITE_648
GGGTCGGAGGGTCGCTCCGGA	ONE_INTERGENIC_SITE_649
GGGTGTGTTGGATCCTCGTCC	ONE_INTERGENIC_SITE_650
GGTAGGTGACGGAACGTAGCT	ONE_INTERGENIC_SITE_651
GGTCATGAGCTATTGGCGTCT	ONE_INTERGENIC_SITE_652
GGTCCAGTTGATAATCGCCTA	ONE_INTERGENIC_SITE_653
GGTCCCCGGAGGAATGAACGG	ONE_INTERGENIC_SITE_654
GGTCCTCGCACCCGTCCTTCG	ONE_INTERGENIC_SITE_655
GGTCGAACGCGCGTCGGGCGT	ONE_INTERGENIC_SITE_656
GGTCGAGCTCGGACGCGACGA	ONE_INTERGENIC_SITE_657
GGTCTAACTTAGGCCTAGGCG	ONE_INTERGENIC_SITE_658
GGTGAAAGTGTAGATCGCACC	ONE_INTERGENIC_SITE_659
GGTGACAGGCAATTCTACTAG	ONE_INTERGENIC_SITE_660
GGTGAGCTTGACACCGTACAG	ONE_INTERGENIC_SITE_661
GGTGATGCTGATCCGATAGAA	ONE_INTERGENIC_SITE_662
GGTGCGAAAGTTCACGCTATG	ONE_INTERGENIC_SITE_663
GGTGCTCACAGCTCGTTTACT	ONE_INTERGENIC_SITE_664
GGTGCTTACAAGCAATCGTCT	ONE_INTERGENIC_SITE_665
GGTGGCTCAGACCTATCCCTA	ONE_INTERGENIC_SITE_666
GGTGTCTGTAAGGACCATCCG	ONE_INTERGENIC_SITE_667
GGTTCAATGAAGGAGTCGTAC	ONE_INTERGENIC_SITE_668
GGTTCCTAGTATAACCCGAAG	ONE_INTERGENIC_SITE_669
GGTTGACTGATTGTCGCACTC	ONE_INTERGENIC_SITE_670
GGTTGGGTTGCGTGGCAATAC	ONE_INTERGENIC_SITE_671
GTAAATATTTATTAGCTCGAG	ONE_INTERGENIC_SITE_672
GTAACACGTAAATACCCTCAC	ONE_INTERGENIC_SITE_673
GTAACCCCACTTCTATCCTAC	ONE_INTERGENIC_SITE_674
GTAATGAAGGAATGGTCGTTT	ONE_INTERGENIC_SITE_675
GTACAGCAACGGAGCAACTCC	ONE_INTERGENIC_SITE_676
GTACCGTACCCACGGTAAAGC	ONE_INTERGENIC_SITE_677
GTACGTGGTTCCCCGTAGTAC	ONE_INTERGENIC_SITE_678
GTAGAGCATTGTAGTCCACGC	ONE_INTERGENIC_SITE_679
GTAGAGTGCATATCCACGTAC	ONE_INTERGENIC_SITE_680
GTAGATCAGTAACTTGCTCCC	ONE_INTERGENIC_SITE_681
GTAGGACACTGATATCTCGCT	ONE_INTERGENIC_SITE_682
GTAGTAATTGACAACACGCAA	ONE_INTERGENIC_SITE_683
GTAGTCCTGCCACAAAGCGAT	ONE_INTERGENIC_SITE_684
GTATAGGAGAATTAGATTCGC	ONE_INTERGENIC_SITE_685
GTATTATACGGCACTACAATA	ONE_INTERGENIC_SITE_686
GTCAAACGAGGGACACTTATC	ONE_INTERGENIC_SITE_687
GTCAAGAGTTACATCGAGGCC	ONE_INTERGENIC_SITE_688
GTCACTGTGGCAATCAACCCC	ONE_INTERGENIC_SITE_689
GTCAGACATTACGATTGGCAA	ONE_INTERGENIC_SITE_690
GTCAGAGGCGGTATTATCGGC	ONE_INTERGENIC_SITE_691
GTCAGAGGTACGCCTAGACCT	ONE_INTERGENIC_SITE_692
GTCAGGAATGGATACCGGATT	ONE_INTERGENIC_SITE_693
GTCAGTTCCTTCGATCCACTC	ONE_INTERGENIC_SITE_694
GTCATGCCTGGTAAAGCGTAC	ONE_INTERGENIC_SITE_695
GTCATGTTAGTCCGCATATTA	ONE_INTERGENIC_SITE_696
GTCCTATAAGGTACCCGCCAA	ONE_INTERGENIC_SITE_697
GTCTCCGAATTCCCACCGCAC	ONE_INTERGENIC_SITE_698
GTCTCCTATGTCAGTGCGTTA	ONE_INTERGENIC_SITE_699
GTCTCGCCCGCAGACAGACGC	ONE_INTERGENIC_SITE_700
GTCTCTGGAGAGCATCGACAT	ONE_INTERGENIC_SITE_701
GTCTGCATTGGACCACACGTA	ONE_INTERGENIC_SITE_702
GTGACAATGAAGATCTACCCC	ONE_INTERGENIC_SITE_703
GTGACTTTGAGTAAATCGTGT	ONE_INTERGENIC_SITE_704
GTGAGTTAGATACTCCCCCAC	ONE_INTERGENIC_SITE_705
GTGATAACCATGTAAACGTCC	ONE_INTERGENIC_SITE_706
GTGATACCTAGATTTACTCAC	ONE_INTERGENIC_SITE_707
GTGCAAATATACACGCGGTAC	ONE_INTERGENIC_SITE_708
GTGCACATCTGAGCACGTCCC	ONE_INTERGENIC_SITE_709
GTGCTGCCATAAAGCAACGAC	ONE_INTERGENIC_SITE_710
GTGGAGGCCAGTCAAAGCGCT	ONE_INTERGENIC_SITE_711
GTGGCATCAATGCGGATATAC	ONE_INTERGENIC_SITE_712
GTGGCTCTGCCGGGTTACCGA	ONE_INTERGENIC_SITE_713
GTGGGACATGAACCAGCGACC	ONE_INTERGENIC_SITE_714
GTGGGTAGAGGGAATACGCTG	ONE_INTERGENIC_SITE_715
GTGTAACCGAAGATCCCGGGA	ONE_INTERGENIC_SITE_716
GTGTCAGCAAACAACGATGTG	ONE_INTERGENIC_SITE_717
GTGTCTAAAATAAGTTCCCGT	ONE_INTERGENIC_SITE_718
GTGTGGATTCACCACTATCCG	ONE_INTERGENIC_SITE_719
GTGTGGGATATAGCCCGACCA	ONE_INTERGENIC_SITE_720
GTGTGTGTTTAAAGAGTGGCG	ONE_INTERGENIC_SITE_721
GTGTGTTGGATCCTCGTCCGG	ONE_INTERGENIC_SITE_722
GTGTTCCATGAGCCATCCCGC	ONE_INTERGENIC_SITE_723
GTTAGGATTACAACCGTCAAG	ONE_INTERGENIC_SITE_724
GTTCCATGGACGAGTACTGAA	ONE_INTERGENIC_SITE_725
GTTCCTTGATTAGATGGACGC	ONE_INTERGENIC_SITE_726
GTTCGGGGCACGCGCTTCATC	ONE_INTERGENIC_SITE_727
GTTCTCAAAATACCCGCCCCG	ONE_INTERGENIC_SITE_728
GTTGGTCAGTCGACGGGAAAC	ONE_INTERGENIC_SITE_729
GTTGTATACACACCATTGGCC	ONE_INTERGENIC_SITE_730
GTTGTTGAACTTCATACGCTT	ONE_INTERGENIC_SITE_731
GTTTACATAAATGATCTCGAG	ONE_INTERGENIC_SITE_732
GTTTAGCGTATAGTGCATGAC	ONE_INTERGENIC_SITE_733
GTTTCTACTAGCGGCCCAAGC	ONE_INTERGENIC_SITE_734
GTTTCTAGCTCCCCTTAGCGG	ONE_INTERGENIC_SITE_735
GTTTGGAAGCCGACTTACATT	ONE_INTERGENIC_SITE_736
GTTTGTAGTTGAGCGACTCTG	ONE_INTERGENIC_SITE_737
TAAAAGCCCATGTAAGTTCCG	ONE_INTERGENIC_SITE_738
TAAACACTTGCGGCATAGTTG	ONE_INTERGENIC_SITE_739
TAAAGTCGGGCGATCTGGTGA	ONE_INTERGENIC_SITE_740
TAAATAAGGCTACGGATTCCA	ONE_INTERGENIC_SITE_741
TAACTAGTAGTACGAGCTTGA	ONE_INTERGENIC_SITE_742
TAACTTACTAAAGTGCGCGCC	ONE_INTERGENIC_SITE_743
TAAGACTAGCCTAGCGTCGAG	ONE_INTERGENIC_SITE_744
TAAGCTATCTAGATCTGGCCG	ONE_INTERGENIC_SITE_745
TAAGCTTGCCCCATAAGCTAC	ONE_INTERGENIC_SITE_746
TAAGTGTATTCATCAAAACGC	ONE_INTERGENIC_SITE_747
TAATATGCATACTCAAGCGCA	ONE_INTERGENIC_SITE_748
TAATATTAAATAATGAGTCGC	ONE_INTERGENIC_SITE_749
TAATGCTATCTTGAACGGTTG	ONE_INTERGENIC_SITE_750
TAATTGTCCCAATGCGCTGGA	ONE_INTERGENIC_SITE_751
TACAATGCTCCGGTCAATGAT	ONE_INTERGENIC_SITE_752
TACAGCTTGCATCGAATCAAC	ONE_INTERGENIC_SITE_753
TACAGTGCAGCTCAATCGGGG	ONE_INTERGENIC_SITE_754
TACATCATGACTTGCGACTGT	ONE_INTERGENIC_SITE_755
TACCACAAATTAACCGCGCTA	ONE_INTERGENIC_SITE_756
TACCGCAAACCAGTAGGCAAT	ONE_INTERGENIC_SITE_757
TACCTTCCAGTTACTCCGACC	ONE_INTERGENIC_SITE_758
TACGACCATGTAATGCGACAC	ONE_INTERGENIC_SITE_759
TACTGAAAGGTACTCTGCACG	ONE_INTERGENIC_SITE_760
TACTTGGGACCCTAGCGTTAG	ONE_INTERGENIC_SITE_761
TAGAAAACCCGAGCCGGGAAT	ONE_INTERGENIC_SITE_762
TAGACAGGATGCTATACCGCA	ONE_INTERGENIC_SITE_763
TAGACCAAGAGTGACACACCG	ONE_INTERGENIC_SITE_764
TAGATCTTCTTGCATCTTTCG	ONE_INTERGENIC_SITE_765
TAGCCAGAGAACCCCCAATAC	ONE_INTERGENIC_SITE_766
TAGCCTGGAACGGGCCCTACA	ONE_INTERGENIC_SITE_767
TAGGAACATATGTCATGACGG	ONE_INTERGENIC_SITE_768
TAGGGGAGGAGTAATAGCGAT	ONE_INTERGENIC_SITE_769
TAGTAACGGGCTAGTCGAGGC	ONE_INTERGENIC_SITE_770
TATATCATCCCAACACGGTTA	ONE_INTERGENIC_SITE_771
TATCAGCCCAGCTCGCAATCG	ONE_INTERGENIC_SITE_772
TATCCAAGGCATCATACGTAA	ONE_INTERGENIC_SITE_773
TATCTTGAGTGCTACGGCTTT	ONE_INTERGENIC_SITE_774
TATGACACTTCCCACCGGTCT	ONE_INTERGENIC_SITE_775
TATGATGCTCCCCATTCGGCC	ONE_INTERGENIC_SITE_776
TATGCAAGGGCATACCCGGGC	ONE_INTERGENIC_SITE_777
TATGGGTTAAAAAACGATCCT	ONE_INTERGENIC_SITE_778
TATTAATCCCCTTGGTAGGTC	ONE_INTERGENIC_SITE_779
TATTACTTTCGGGCGACTTCA	ONE_INTERGENIC_SITE_780
TATTTCTGTACGACGTTAAGC	ONE_INTERGENIC_SITE_781
TCAAACTAGCGGAGACTTGAC	ONE_INTERGENIC_SITE_782
TCAACTCTGGTCTCCTCACCG	ONE_INTERGENIC_SITE_783
TCAACTTGCGCTTGCGCTCTT	ONE_INTERGENIC_SITE_784
TCAATCGTTAGGAGCGTGGAT	ONE_INTERGENIC_SITE_785
TCACAATATAGGCTATTACGG	ONE_INTERGENIC_SITE_786
TCACCATAGTAGATCGTCAAC	ONE_INTERGENIC_SITE_787
TCACCCCTCTGTAGTCGAGAA	ONE_INTERGENIC_SITE_788
TCACCTCGCCCTAAGACCACT	ONE_INTERGENIC_SITE_789
TCACGCCATTCCGTCGTGTGG	ONE_INTERGENIC_SITE_790
TCACTGTGGTCCAATCGAATC	ONE_INTERGENIC_SITE_791
TCAGATAACATGATTCTCGTT	ONE_INTERGENIC_SITE_792
TCAGCCAGTAGGTGGCAACCG	ONE_INTERGENIC_SITE_793
TCAGCGGACACAACGTCTGAA	ONE_INTERGENIC_SITE_794
TCAGGGAATCTAAACGGCCTG	ONE_INTERGENIC_SITE_795
TCAGTCCTACAAGTTTACCAA	ONE_INTERGENIC_SITE_796
TCAGTTACCTAGGCGTCCTAT	ONE_INTERGENIC_SITE_797
TCATCATAGAATGTACCGTCA	ONE_INTERGENIC_SITE_798
TCATCCTGTTAATAACGCCAG	ONE_INTERGENIC_SITE_799
TCATGATATATAGATGTACCG	ONE_INTERGENIC_SITE_800
TCATGCAATAAAGCTATCGCC	ONE_INTERGENIC_SITE_801
TCATGGACAAGATACATGCGC	ONE_INTERGENIC_SITE_802
TCATTCGGGTTTAGCCCACCT	ONE_INTERGENIC_SITE_803
TCCAAAGCCGAGTTGTACGAA	ONE_INTERGENIC_SITE_804
TCCAGATGTGATTCATGCGGC	ONE_INTERGENIC_SITE_805
TCCCAAAGAGTGTGTCGGCCT	ONE_INTERGENIC_SITE_806
TCCCAGACTAGAACTACTACG	ONE_INTERGENIC_SITE_807
TCCCATGGACCATGCGTTAAA	ONE_INTERGENIC_SITE_808
TCCCCATGATCTCACGATTGA	ONE_INTERGENIC_SITE_809
TCCCCTAGATAGAAGTCGTCC	ONE_INTERGENIC_SITE_810
TCCCCTTTATCCCGCGATGAA	ONE_INTERGENIC_SITE_811
TCCCGCTACCTCCGTTAGACG	ONE_INTERGENIC_SITE_812
TCCTACAGATCCGATTATTGC	ONE_INTERGENIC_SITE_813
TCCTCAGTTCGAGCCTTATGC	ONE_INTERGENIC_SITE_814
TCCTGCCTGATATAAATTCGT	ONE_INTERGENIC_SITE_815
TCCTGGAAATGGGGTATCCCG	ONE_INTERGENIC_SITE_816
TCCTGTCTGTCCCCCGCGGCG	ONE_INTERGENIC_SITE_817
TCGACCATATGATCTCTTCGA	ONE_INTERGENIC_SITE_818
TCGGACTTGTGGAATGCGACC	ONE_INTERGENIC_SITE_819
TCGTATTCTGACGATACGAAC	ONE_INTERGENIC_SITE_820
TCGTGGCCGCGGCACTTCGCA	ONE_INTERGENIC_SITE_821
TCTAATGGATACAAGTAACCG	ONE_INTERGENIC_SITE_822
TCTAATGGCCGTTGTAGTATG	ONE_INTERGENIC_SITE_823
TCTACGAGTCGAATGACCCTG	ONE_INTERGENIC_SITE_824
TCTATACCATCGCACGCTGCC	ONE_INTERGENIC_SITE_825
TCTGACCCTCGATTGACTAGC	ONE_INTERGENIC_SITE_826
TCTGACTGCATCCGTCCACCG	ONE_INTERGENIC_SITE_827
TCTGAGCCTACTCTTACCGAG	ONE_INTERGENIC_SITE_828
TCTGCACTATAAATCCCCCAC	ONE_INTERGENIC_SITE_829
TCTGCACTGTCTTACTCGAAT	ONE_INTERGENIC_SITE_830
TCTGCCCAGACCAACCCTTCA	ONE_INTERGENIC_SITE_831
TCTGGACTGGGTATATCATAC	ONE_INTERGENIC_SITE_832
TCTGTAAAGTGAGTTGCACGG	ONE_INTERGENIC_SITE_833
TCTTATAACCCATTCGAGTAA	ONE_INTERGENIC_SITE_834
TCTTGCACCTCACCATCGTGA	ONE_INTERGENIC_SITE_835
TCTTGCTACAAATTTGAGCCG	ONE_INTERGENIC_SITE_836
TGAACATTGTATCCTTCGCAA	ONE_INTERGENIC_SITE_837
TGAACGGAAAAGGACGGCGAA	ONE_INTERGENIC_SITE_838
TGAACTGAAATACCCGGATTA	ONE_INTERGENIC_SITE_839
TGAAGCTATTATTACCGAAAC	ONE_INTERGENIC_SITE_840
TGAATCCATAAGTAAGCCGGA	ONE_INTERGENIC_SITE_841
TGACATAGGCACTGATCGTGT	ONE_INTERGENIC_SITE_842
TGACATGGATCCTGGTTACGT	ONE_INTERGENIC_SITE_843
TGACTCCATATACTGGCGCCA	ONE_INTERGENIC_SITE_844
TGACTGCTAGAGTCAGCGTAG	ONE_INTERGENIC_SITE_845
TGAGCTTCGCACCATGTATGG	ONE_INTERGENIC_SITE_846
TGAGGAATTTCTAACCGATGA	ONE_INTERGENIC_SITE_847
TGAGGCCTGCAAACTTGGACG	ONE_INTERGENIC_SITE_848
TGATAGATGTTGGAAACCCGG	ONE_INTERGENIC_SITE_849
TGATATCCAACAGTCATGCGC	ONE_INTERGENIC_SITE_850
TGATGAAGGAGACCAACTCGC	ONE_INTERGENIC_SITE_851
TGATGAAGGAGATACCCACGA	ONE_INTERGENIC_SITE_852
TGATGCATGAGTCCCCCCTGA	ONE_INTERGENIC_SITE_853
TGATGCTAGCAGGACGGGTGA	ONE_INTERGENIC_SITE_854
TGATGTAGGGAAAGGCGTACG	ONE_INTERGENIC_SITE_855
TGCAACGCTCCCATTAGCTGA	ONE_INTERGENIC_SITE_856
TGCAAGAAGTTCCATATTCCG	ONE_INTERGENIC_SITE_857
TGCACTAACGCATGTTTGGTC	ONE_INTERGENIC_SITE_858
TGCACTCGCGGTGGCCTTATG	ONE_INTERGENIC_SITE_859
TGCAGACAGCTAACGTCCCTA	ONE_INTERGENIC_SITE_860
TGCAGAGTATGACCTCGATAT	ONE_INTERGENIC_SITE_861
TGCAGGCTGCGAGACACTCGT	ONE_INTERGENIC_SITE_862
TGCAGGGCCCGACCCGGGCGA	ONE_INTERGENIC_SITE_863
TGCAGTTATTGAACCGCATGA	ONE_INTERGENIC_SITE_864
TGCAGTTGGCAGTATCCCGGC	ONE_INTERGENIC_SITE_865
TGCATACCATATCCGTTCATA	ONE_INTERGENIC_SITE_866
TGCATCCCCTGACACCGAGCA	ONE_INTERGENIC_SITE_867
TGCCCACAGTCTGCTACACGA	ONE_INTERGENIC_SITE_868
TGCCCATCAGATTATCGAAGG	ONE_INTERGENIC_SITE_869
TGCCCATGACTATAATCGGAC	ONE_INTERGENIC_SITE_870
TGCCCCTTTCTATGGATACCG	ONE_INTERGENIC_SITE_871
TGCCCTATTCCAACTAGGTAC	ONE_INTERGENIC_SITE_872
TGCCTCCTCTTGGGCGGGTTA	ONE_INTERGENIC_SITE_873
TGCCTGCACTACGACGCAACA	ONE_INTERGENIC_SITE_874
TGCCTGTTTAATCGTGCCTCA	ONE_INTERGENIC_SITE_875
TGCGACCTTCGAACCCCCCCT	ONE_INTERGENIC_SITE_876
TGCTATTGGTATCACACGAAG	ONE_INTERGENIC_SITE_877
TGCTCATTCCCAAGCTAACGT	ONE_INTERGENIC_SITE_878
TGCTCCTATGTACGATAGGGT	ONE_INTERGENIC_SITE_879
TGCTGAAACCAACGTCTACGG	ONE_INTERGENIC_SITE_880
TGCTGAACTGACTCTAACGCA	ONE_INTERGENIC_SITE_881
TGCTGTCTTGGAAGCCTCGAC	ONE_INTERGENIC_SITE_882
TGCTTCGTGTACTTCGTCAAC	ONE_INTERGENIC_SITE_883
TGCTTGGGAGCAACGCCGATG	ONE_INTERGENIC_SITE_884
TGCTTGGTACCATGCCTCGAT	ONE_INTERGENIC_SITE_885
TGGAAAGGCCCTCGACTACTG	ONE_INTERGENIC_SITE_886
TGGATCCTACAAACGTCCCGG	ONE_INTERGENIC_SITE_887
TGGCAGAATACTCAGCGTTGC	ONE_INTERGENIC_SITE_888
TGGCTCAGACGATAATCTGCC	ONE_INTERGENIC_SITE_889
TGGGAGCTACGGTTCGAGTAG	ONE_INTERGENIC_SITE_890
TGGGATGTGAGCCCATCGACC	ONE_INTERGENIC_SITE_891
TGGGGACACAGAGATAGCCGC	ONE_INTERGENIC_SITE_892
TGGGGTATCCCGTTGTCGGGC	ONE_INTERGENIC_SITE_893
TGGTAAAGAGTGCCATACCGA	ONE_INTERGENIC_SITE_894
TGGTCATAATTACACGACCAT	ONE_INTERGENIC_SITE_895
TGGTCTCCGTGCAATGAACCA	ONE_INTERGENIC_SITE_896
TGGTTAAAAGCTCATCAATCG	ONE_INTERGENIC_SITE_897
TGTAAACCCATAGACTATGCG	ONE_INTERGENIC_SITE_898
TGTACCTTATCGCCTTACGGG	ONE_INTERGENIC_SITE_899
TGTAGGATATCGCTACCAAAC	ONE_INTERGENIC_SITE_900
TGTATATAAGAAGCTCTCCGG	ONE_INTERGENIC_SITE_901
TGTCATGGTGTGGACGCATGC	ONE_INTERGENIC_SITE_902
TGTCCTACATACCACGGACAG	ONE_INTERGENIC_SITE_903
TGTCCTACCGTACAAAGGCGC	ONE_INTERGENIC_SITE_904
TGTCCTTTAGGACTGCCATAC	ONE_INTERGENIC_SITE_905
TGTCGGGTGCGAGTCATGCAA	ONE_INTERGENIC_SITE_906
TGTCTAGGGAGTTAGCGGTTC	ONE_INTERGENIC_SITE_907
TGTGAGCACGTGCATAACGGT	ONE_INTERGENIC_SITE_908
TGTGAGCCAGTTAATACTGCG	ONE_INTERGENIC_SITE_909
TGTGCCCTCATGTGATGGCGC	ONE_INTERGENIC_SITE_910
TGTGGTCAAAGATGTAACCGG	ONE_INTERGENIC_SITE_911
TGTGTCTGGCGTTTATAGCCG	ONE_INTERGENIC_SITE_912
TGTTACGAAACTCTGACCCGC	ONE_INTERGENIC_SITE_913
TGTTCACACTTGTTTGGACCG	ONE_INTERGENIC_SITE_914
TGTTCATGTAGAAGGCGATAC	ONE_INTERGENIC_SITE_915
TGTTCGGAGCGCTTTCCGTGG	ONE_INTERGENIC_SITE_916
TGTTTGAGCAACATGCGTTTG	ONE_INTERGENIC_SITE_917
TGTTTGGCGGGACATATGATC	ONE_INTERGENIC_SITE_918
TTAAACGGTCAGAACAACATC	ONE_INTERGENIC_SITE_919
TTAAACGTGAGTGAGAAACGC	ONE_INTERGENIC_SITE_920
TTAAAGCCGGGTGAGTGCATA	ONE_INTERGENIC_SITE_921
TTAACTGGTTGTGCTGGCGAT	ONE_INTERGENIC_SITE_922
TTACCAATGCTGGAGTGCCGA	ONE_INTERGENIC_SITE_923
TTACGGATGTATTCATTACGG	ONE_INTERGENIC_SITE_924
TTACGTGATAACAGGTGCTCG	ONE_INTERGENIC_SITE_925
TTACTGATCGTAGGATGTCTA	ONE_INTERGENIC_SITE_926
TTAGAATCTTCAGGGCTTTCG	ONE_INTERGENIC_SITE_927
TTAGACCGGCAACTCACGTGA	ONE_INTERGENIC_SITE_928
TTAGAGACACAGATCGATGGC	ONE_INTERGENIC_SITE_929
TTAGCACCATATGTTATCGGC	ONE_INTERGENIC_SITE_930
TTAGGTTTCTTCAGACGCATA	ONE_INTERGENIC_SITE_931
TTAGTCACTATTTGCTTCGCA	ONE_INTERGENIC_SITE_932
TTAGTCCTCCCCTCAAATACG	ONE_INTERGENIC_SITE_933
TTATAGGACAGCGTGCGTAAG	ONE_INTERGENIC_SITE_934
TTATGATACACGGTAGCGTGG	ONE_INTERGENIC_SITE_935
TTATGCCTCTGAGAATACGAC	ONE_INTERGENIC_SITE_936
TTATGGTGGTATGATACCGCT	ONE_INTERGENIC_SITE_937
TTCAAACTTTAGGAGTCGGCA	ONE_INTERGENIC_SITE_938
TTCACGGGCTATACCATATGC	ONE_INTERGENIC_SITE_939
TTCAGCGATTTGTTCTCAGCG	ONE_INTERGENIC_SITE_940
TTCAGTGTTGCCCTACATAGA	ONE_INTERGENIC_SITE_941
TTCAGTTCTCAGACTATCGGA	ONE_INTERGENIC_SITE_942
TTCATGAAGAACTGTTACGTC	ONE_INTERGENIC_SITE_943
TTCTACAAGGTGACTACTCCA	ONE_INTERGENIC_SITE_944
TTCTCTTGGATTCATAAATCG	ONE_INTERGENIC_SITE_945
TTCTGTGTGGCTAACGTTAAC	ONE_INTERGENIC_SITE_946
TTGAATTAAATGTGCGGCTCC	ONE_INTERGENIC_SITE_947
TTGATGTCACCGGGGCACGCC	ONE_INTERGENIC_SITE_948
TTGCCACTGGAAAATCCTCCG	ONE_INTERGENIC_SITE_949
TTGCCTGTTTACAGTAGTGCG	ONE_INTERGENIC_SITE_950
TTGGAAATTGTATGGTGCCGG	ONE_INTERGENIC_SITE_951
TTGGATGATTTATAGTTCGAA	ONE_INTERGENIC_SITE_952
TTGGCCCTCTGCTGGCTCGAT	ONE_INTERGENIC_SITE_953
TTGGGCAGGTCTCCGTAGTAA	ONE_INTERGENIC_SITE_954
TTGGTAGGCTTGTTAAAAGCG	ONE_INTERGENIC_SITE_955
TTGGTCTTAAGCATTAAGCGC	ONE_INTERGENIC_SITE_956
TTGGTTTAATCGTCCCTAACC	ONE_INTERGENIC_SITE_957
TTGTCATCGGTATATGACACG	ONE_INTERGENIC_SITE_958
TTGTCCTCGAAGATAGCATGC	ONE_INTERGENIC_SITE_959
TTGTCGCCCATACATCCGATA	ONE_INTERGENIC_SITE_960
TTGTTCATAATCCACACGGTC	ONE_INTERGENIC_SITE_961
TTGTTCCGTTGCAAATCAATC	ONE_INTERGENIC_SITE_962
TTGTTGCTAAAACAGTCCGTC	ONE_INTERGENIC_SITE_963
TTGTTTCAATAATAATACCGC	ONE_INTERGENIC_SITE_964
TTTAAGAAAAGTGGTTCGTCA	ONE_INTERGENIC_SITE_965
TTTATAGTTAACCAATCCCAC	ONE_INTERGENIC_SITE_966
TTTATTACGAGCTATCCTTGC	ONE_INTERGENIC_SITE_967
TTTCAAAGTTATATCCCGTTG	ONE_INTERGENIC_SITE_968
TTTCCAAGAAATTTGTGCGAA	ONE_INTERGENIC_SITE_969
TTTCCACACAATGGGTATGAC	ONE_INTERGENIC_SITE_970
TTTCCCTCTACAGCCGGTGAC	ONE_INTERGENIC_SITE_971
TTTCGTTTACCACCCGTCCCT	ONE_INTERGENIC_SITE_972
TTTCTGTGTTCCGTACGACAA	ONE_INTERGENIC_SITE_973
TTTCTTGTGCTAAGGCCACGT	ONE_INTERGENIC_SITE_974
TTTGACGCAGTTCGAACATCA	ONE_INTERGENIC_SITE_975
TTTGAGAGCTCATTACGTGGT	ONE_INTERGENIC_SITE_976
TTTGCTAAATCCCGCCCACGT	ONE_INTERGENIC_SITE_977
TTTGGAAAATTGGGCTCGTCC	ONE_INTERGENIC_SITE_978
TTTGGGGGAGAATCGTGCTCA	ONE_INTERGENIC_SITE_979
TTTGGGTGCATAATTCATGCG	ONE_INTERGENIC_SITE_980
TTTGTACCTTCTCGCCTAACT	ONE_INTERGENIC_SITE_981
TTTGTACTCATGTAATCGCCT	ONE_INTERGENIC_SITE_982
TTTGTCCATTATGCATAACCC	ONE_INTERGENIC_SITE_983
TTTGTTACCAACGGTTAACCA	ONE_INTERGENIC_SITE_984
TTTGTTTGATGCATTAGTTCG	ONE_INTERGENIC_SITE_985