sgRNA Sequence	Target Gene Symbol
TAGTTAATAAGAGGCCTACCCTG	ONE_NON-GENE_SITE_1
CCCGGGTATAGCGCATGTGGAGG	ONE_NON-GENE_SITE_2
CTAAACCGGAGAACGTAAAAATA	ONE_NON-GENE_SITE_3
ATTACAGTACCGTGATAGCAAAA	ONE_NON-GENE_SITE_4
CCTGAGATACGTAGAACTATTAC	ONE_NON-GENE_SITE_5
CTCTGACGTTATACAAAGCATAT	ONE_NON-GENE_SITE_6
GTATGCACGTATAGGGGTGTCTG	ONE_NON-GENE_SITE_7
CAAGCTACAAGCGATGCTTTACA	ONE_NON-GENE_SITE_8
TGTATGCATGCCCTACTACATCA	ONE_NON-GENE_SITE_9
CAAATCCGTGAAAGCCCAAAGCC	ONE_NON-GENE_SITE_10
AATCAACTATAGCGTATAATGTC	ONE_NON-GENE_SITE_11
CAAGTGAAGTGCTCTCGCACAAA	ONE_NON-GENE_SITE_12
GTCTTAGCACAGTCAACGTTAAT	ONE_NON-GENE_SITE_13
GAAGCACGTAATTGATTACCTCC	ONE_NON-GENE_SITE_14
CCCTAATGTGTCTACCTGAGAAT	ONE_NON-GENE_SITE_15
GGAGGTTACGAAACATATCTTTA	ONE_NON-GENE_SITE_16
GATCCTCTAAGTAAGTGACTATT	ONE_NON-GENE_SITE_17
TCGGTGGTCCCTTGATATGTCCA	ONE_NON-GENE_SITE_18
AGGGCTCCCAGTATTAATCCATA	ONE_NON-GENE_SITE_19
GGGTAATATAGCCTCGTAATATA	ONE_NON-GENE_SITE_20
GTTGTCACAATACCCTTAGATGT	ONE_NON-GENE_SITE_21
GGCAGAATGTTGTTCGAAGAGAG	ONE_NON-GENE_SITE_22
GTTGCATGCCGCAAAAAGGACTG	ONE_NON-GENE_SITE_23
CACTTCCAATAGGGTTAACCATC	ONE_NON-GENE_SITE_24
CCTAGGCTTAACCACCGACAATT	ONE_NON-GENE_SITE_25
ATACGCCTATCCATTTGTGCCAA	ONE_NON-GENE_SITE_26
CACGCACGGTAGATGGAATGGAA	ONE_NON-GENE_SITE_27
CGAAGTGCCACTCTCAAGTAATA	ONE_NON-GENE_SITE_28
CCAACTATGGAAGCTTACGCTGC	ONE_NON-GENE_SITE_29
GCGGAATATCACAAGAGGTGAAA	ONE_NON-GENE_SITE_30
AGGCATGTTCCCGAGCTTACCAG	ONE_NON-GENE_SITE_31
GTCCGTCATTCATCCCATGAGCA	ONE_NON-GENE_SITE_32
AGGTATGAGTCAGTTTACGGACC	ONE_NON-GENE_SITE_33
GGTACCATTACCATTGGGGGTAT	ONE_NON-GENE_SITE_34
AATCGATGCTATGTTCACCACCA	ONE_NON-GENE_SITE_35
GACTATCATAGTAGGCCTGGATG	ONE_NON-GENE_SITE_36
CCCAAGGCTAGTGCTAGTACATA	ONE_NON-GENE_SITE_37
CCTCAACACTACCGCATCAACAC	ONE_NON-GENE_SITE_38
TCATTGGTCTTACATGACCAAAG	ONE_NON-GENE_SITE_39
CTCGCCCGATTCCAATGTGAGTT	ONE_NON-GENE_SITE_40
AGGGACGTAGCTTATGCTGGTTT	ONE_NON-GENE_SITE_41
TACTAGGTGAGTCCAAGATAGTT	ONE_NON-GENE_SITE_42
GCCTACGTATCACCACATATTGG	ONE_NON-GENE_SITE_43
ACGACAGGACTCTATACTCTCTG	ONE_NON-GENE_SITE_44
ATTCCCGAAAGGTCTAAGCCTCT	ONE_NON-GENE_SITE_45
CCTATCCTTAGTAATGGACCTAC	ONE_NON-GENE_SITE_46
CCCAATAGAGTTGTCTGGCTACT	ONE_NON-GENE_SITE_47
TAAGTTGTAACGTGCCCTACTGT	ONE_NON-GENE_SITE_48
GGTTACCAATAGCCTTGTAGTAT	ONE_NON-GENE_SITE_49
CGTCTAACCCTTTGAACAGACAA	ONE_NON-GENE_SITE_50
GGCTCAACAGTTATGCATCAATG	ONE_NON-GENE_SITE_51
GTAGAGGATTCTAGCCTTCATTA	ONE_NON-GENE_SITE_52
CTTGAATGGGTTACTCGAAGCAA	ONE_NON-GENE_SITE_53
TACGTCCCTCCTGTTAGTCACTG	ONE_NON-GENE_SITE_54
GGTGTATGCCGCCAACATACTAA	ONE_NON-GENE_SITE_55
AGGCTCATCCCGCGTTGCAGAAC	ONE_NON-GENE_SITE_56
GTATCCGTTACATACAGCCAAAC	ONE_NON-GENE_SITE_57
GTGTTATGTGCCGTATAAATCAG	ONE_NON-GENE_SITE_58
TCCCAAGCTACGCATATATATTC	ONE_NON-GENE_SITE_59
CGCTACGAATATCAGTTAACAGT	ONE_NON-GENE_SITE_60
GTGTACTAAGATTACTAGTGGAT	ONE_NON-GENE_SITE_61
TCTCTAAGCGCATATTAAGTTAC	ONE_NON-GENE_SITE_62
GGCAGAGGCGAATTTAATATAGG	ONE_NON-GENE_SITE_63
AGTCAATACGCCTCTCAACCCTC	ONE_NON-GENE_SITE_64
CAACTGGTGACGACAAATATGCC	ONE_NON-GENE_SITE_65
CGAAGTGCTTATATAACACACCC	ONE_NON-GENE_SITE_66
ACATGCGACTTCTAAGTTAGTAA	ONE_NON-GENE_SITE_67
GTTAGGTAACCAACAGACCTCTG	ONE_NON-GENE_SITE_68
CGGAGGGTTTACTATGAACCAAG	ONE_NON-GENE_SITE_69
GGCTTTGTAGGCTATCCTAACTA	ONE_NON-GENE_SITE_70
CTATATACCTACATGACGTTTGC	ONE_NON-GENE_SITE_71
TCCGTATAAATCCATTGCCCATT	ONE_NON-GENE_SITE_72
ACTAATGCGAACTTAATGAGGGC	ONE_NON-GENE_SITE_73
CAATGGGCCAAGCGGTATTCTTG	ONE_NON-GENE_SITE_74
ATCGAGTTAGATGAAACTAACTG	ONE_NON-GENE_SITE_75
GGTATAACTCTGCTTAGAGTCAA	ONE_NON-GENE_SITE_76
AGGATCATAGCCGTATGGCCAGA	ONE_NON-GENE_SITE_77
ATTCCTGCTCGCTACACGACGTA	ONE_NON-GENE_SITE_78
AATGGGCTGACCGGATTTGTCCC	ONE_NON-GENE_SITE_79
CTATCTGACCAGTAGAGCCCGTA	ONE_NON-GENE_SITE_80
GGGCAAGTCCTAAGATAGGTGGG	ONE_NON-GENE_SITE_81
GCTAGCCAGTTGTAATACACCAA	ONE_NON-GENE_SITE_82
CATTATCGTCCCTGCCTAGAAGC	ONE_NON-GENE_SITE_83
CTAGGTTGCAGTGTTAAACACAT	ONE_NON-GENE_SITE_84
CCACGTCAAGTATTCTCAAAAAC	ONE_NON-GENE_SITE_85
CTCGAACAATACTTAAGTGATGT	ONE_NON-GENE_SITE_86
GCAGCTAACGGTATCTGTTACCC	ONE_NON-GENE_SITE_87
GTGGATAGGTAGGGTACAATTAG	ONE_NON-GENE_SITE_88
ACTCGCTAAACTCATGGGCATCT	ONE_NON-GENE_SITE_89
AAACATCGTATGACACTAGTGAG	ONE_NON-GENE_SITE_90
AAATCGGACACTCCTATGCCAAA	ONE_NON-GENE_SITE_91
ACATAGACCAGATCCCGTTTGCA	ONE_NON-GENE_SITE_92
AGAATGTTAGATGCCGAGTATCA	ONE_NON-GENE_SITE_93
TGTATAACACTCCTCTACGGTAA	ONE_NON-GENE_SITE_94
AATAAGTGCCACAGTCGCAGTAA	ONE_NON-GENE_SITE_95
CAGAATAGTGGCAGACCGTGTTA	ONE_NON-GENE_SITE_96
ACCTAGGGATTCCTACATGCATG	ONE_NON-GENE_SITE_97
GGCACGATAACAGGAGCACCTGT	ONE_NON-GENE_SITE_98
ACCGAGCCTAAGCCATGTACCCT	ONE_NON-GENE_SITE_99
TCCTATAGTGTGCACCTCATGAG	ONE_NON-GENE_SITE_100
TAACTGCTTACTCTCGGATACCG	ONE_NON-GENE_SITE_101
GGATATCCTAACTGCCGTAACCG	ONE_NON-GENE_SITE_102
AGGGGGTCGTCTCAACACCAGAA	ONE_NON-GENE_SITE_103
GACAACGGACAATAGTTAGCATG	ONE_NON-GENE_SITE_104
ATACACTCCGTTGGCATTATCTT	ONE_NON-GENE_SITE_105
CATTACCTACCTCGGGTAAATAT	ONE_NON-GENE_SITE_106
GACGTAATCGGCTTCCACATTTC	ONE_NON-GENE_SITE_107
TTACGATAGCCCTAAGCAGCGAG	ONE_NON-GENE_SITE_108
TGCCGTGCTACAAACCTCCTGGT	ONE_NON-GENE_SITE_109
GGTGAGTATGATACAATCCATTG	ONE_NON-GENE_SITE_110
TCAACCAACGGTACCTAATTGAT	ONE_NON-GENE_SITE_111
GAATGCTTAGATACGCAGAATTT	ONE_NON-GENE_SITE_112
CCTAGTCCGATGGCTACAAGGGA	ONE_NON-GENE_SITE_113
TACTAGGGCCCAATAAGGAGCAA	ONE_NON-GENE_SITE_114
AACGTGAGAGTTGCATCAACGGT	ONE_NON-GENE_SITE_115
TAAGACCCCTGTAGCACTAGAGG	ONE_NON-GENE_SITE_116
CCCCCTAATGTTTCGCCCTCTGC	ONE_NON-GENE_SITE_117
TAAATATGAGCCCGTGCATATCT	ONE_NON-GENE_SITE_118
AGGTTGGGAAGTTACGGAAGAAA	ONE_NON-GENE_SITE_119
ATCTTTCCCACACGGACTCCTTC	ONE_NON-GENE_SITE_120
ATTACGCTGCGGGTATATTTAGT	ONE_NON-GENE_SITE_121
GTCACCCAGTATATTACTCTCTC	ONE_NON-GENE_SITE_122
AAATTACTCTATGGGCGTAACAG	ONE_NON-GENE_SITE_123
ACCAGAATAGAATGATCGGAGAG	ONE_NON-GENE_SITE_124
TGGGGGATAGTAGTATTAGTAGT	ONE_NON-GENE_SITE_125
ATAGGGTTATAGTGGCCCTTAGC	ONE_NON-GENE_SITE_126
TAGTCTATCGTGGATAGCCTAGT	ONE_NON-GENE_SITE_127
GACAGTATTCCTTACTAACACAA	ONE_NON-GENE_SITE_128
CTATCCGGTAACATACATAGTGA	ONE_NON-GENE_SITE_129
GGATCGCTCAATACTAGAAACCA	ONE_NON-GENE_SITE_130
TCTAGCACTTAACGTTACTAAGT	ONE_NON-GENE_SITE_131
CATGATGGCTCATCGAGTTAAAA	ONE_NON-GENE_SITE_132
TATAACGCTAATGTCTCCCCTTC	ONE_NON-GENE_SITE_133
GAGACCGTTCCATGTACACTAGA	ONE_NON-GENE_SITE_134
TATACCCCTGATCTATGCATGGA	ONE_NON-GENE_SITE_135
GCAACTAATACACCCCCTTCCAG	ONE_NON-GENE_SITE_136
TCTAGCAGCTAACCCAACCTTGG	ONE_NON-GENE_SITE_137
CCGACATAATACGTTTAGAACAG	ONE_NON-GENE_SITE_138
GTTTGGAACACTCAATCGTGTCA	ONE_NON-GENE_SITE_139
GCGTCAGTGGTGACTAAAGATTT	ONE_NON-GENE_SITE_140
AGTAGGTATGATAACTAGGATTA	ONE_NON-GENE_SITE_141
AGCTAGGTATACCGTATCATCTG	ONE_NON-GENE_SITE_142
TCTATAATGCACGTTTGGGTACA	ONE_NON-GENE_SITE_143
CTTCCACCGATCGGTTCTTCCAA	ONE_NON-GENE_SITE_144
TACCTCTCCATAGTCGGATATAG	ONE_NON-GENE_SITE_145
GCATGCAATGATAGCGTCTCTAA	ONE_NON-GENE_SITE_146
GACTTGCTTGCACCATATCCTGT	ONE_NON-GENE_SITE_147
GTACCAACAGTCTTAGGTCGAGT	ONE_NON-GENE_SITE_148
TCTGACCTACTACCGACAGCATA	ONE_NON-GENE_SITE_149
GACTACTAGATGTGTGGTGGCTT	ONE_NON-GENE_SITE_150
AATTAGGGCCTTCGGTATATTAG	ONE_NON-GENE_SITE_151
AGTATGCCATCGGTACAGGCTCA	ONE_NON-GENE_SITE_152
ACTCCTTACCCGTACCATAAATC	ONE_NON-GENE_SITE_153
CATGCACCGTTGTCATGTTTTTC	ONE_NON-GENE_SITE_154
AACCTGAGGGGGTGTAATCTCTG	ONE_NON-GENE_SITE_155
GAACTGCCACTATGTAGACGTCC	ONE_NON-GENE_SITE_156
GCTAATCAGAGTAGGCGCTGCTT	ONE_NON-GENE_SITE_157
AAACATTGACCTACAATCGTTTA	ONE_NON-GENE_SITE_158
AGAACCCTAGGGTAGCTACTTAG	ONE_NON-GENE_SITE_159
AGGATTCATCGTTGGTATAGGTA	ONE_NON-GENE_SITE_160
TAGCAGTAAATGCACGTAGTAGA	ONE_NON-GENE_SITE_161
GCAGTTATAGATCGCATATGACT	ONE_NON-GENE_SITE_162
GCAACAACTAGTGTGAACGTGTG	ONE_NON-GENE_SITE_163
GTAAGATCGGCCTTACAACAAAA	ONE_NON-GENE_SITE_164
CATTCTAGTTACGGGACACAGAG	ONE_NON-GENE_SITE_165
ATACGTGAGCTCTAGCATCACCC	ONE_NON-GENE_SITE_166
ATGTTATCCAAGGGGAGTAATCA	ONE_NON-GENE_SITE_167
AGAGTATTCTATCTAGTGCTATC	ONE_NON-GENE_SITE_168
GGTAAGTAGCCAACTAACCAAGC	ONE_NON-GENE_SITE_169
TACTAGGTCGTGTTAACACTTAC	ONE_NON-GENE_SITE_170
GGTATAAGGTGACACTTATACCT	ONE_NON-GENE_SITE_171
AGCCAAGCGTCCTAATTTGTCAA	ONE_NON-GENE_SITE_172
AGGTAGTACTATGGACCGAATTG	ONE_NON-GENE_SITE_173
TCTAGCGTGTAAGCCTGCTTCTA	ONE_NON-GENE_SITE_174
GGGTATGGGCAGTTAAAACTATA	ONE_NON-GENE_SITE_175
AATAGAAACCTTATACGCGAGAA	ONE_NON-GENE_SITE_176
CAGCACGTCTACTAATATCTAAG	ONE_NON-GENE_SITE_177
TTGTTAGCTAGTCTAGCACTCTA	ONE_NON-GENE_SITE_178
GCGAGTGGTTAACCCAATGACGA	ONE_NON-GENE_SITE_179
GTGAGGTATAAATGTACGCAGAG	ONE_NON-GENE_SITE_180
GGTAGGCTAGCAAACAGCCACCT	ONE_NON-GENE_SITE_181
GTAAACTACCATTATATCGAAGA	ONE_NON-GENE_SITE_182
GTCATAGGTCACCCGATTTATTC	ONE_NON-GENE_SITE_183
TCGTGCTATGAGGCCTAAATAAA	ONE_NON-GENE_SITE_184
AACGCTCCTTGATAAGTGATAGG	ONE_NON-GENE_SITE_185
GGAATGCACTCTACGTAAGATAT	ONE_NON-GENE_SITE_186
GGAACGTCTACTGTGCACCAGGT	ONE_NON-GENE_SITE_187
CCCCACGTGGTTGTAAAGTCCTA	ONE_NON-GENE_SITE_188
GAGATCTTATCTAGTGCTCTGGC	ONE_NON-GENE_SITE_189
TAAGCCTGATCGCAAAACAGAAA	ONE_NON-GENE_SITE_190
CCATAGAAATCTCGGTTAGCAAT	ONE_NON-GENE_SITE_191
ATGGGATCACTTACGGCCTCCAC	ONE_NON-GENE_SITE_192
TGTTGGATCGACAAAACACATGG	ONE_NON-GENE_SITE_193
CCTCCTGTATCAACGATTGTTTT	ONE_NON-GENE_SITE_194
GGAACTTGAATCTAGTAGCAGCA	ONE_NON-GENE_SITE_195
GATTTGTCCGTATGGAAACACAG	ONE_NON-GENE_SITE_196
AATACTCTACTAGTTGAGGACTT	ONE_NON-GENE_SITE_197
CGTTAGAGTATTGACACCCATTC	ONE_NON-GENE_SITE_198
GGATATTCTATGACGCATCAATT	ONE_NON-GENE_SITE_199
GGACATTACATATTAGACCAGAT	ONE_NON-GENE_SITE_200
AAAGCCACCGGTGTATGAGACTC	ONE_NON-GENE_SITE_201
AGAACCTTACGGTAACTTCATCT	ONE_NON-GENE_SITE_202
GCGTGCTACATGCAAACGCAGCA	ONE_NON-GENE_SITE_203
CTATCGCAGTGGGATAATGTGCA	ONE_NON-GENE_SITE_204
GACCTATGCGTTTAACAGCTCTC	ONE_NON-GENE_SITE_205
TGTTCGCGGAACCTGAACTTCAG	ONE_NON-GENE_SITE_206
ACGTAGCAGTTAGAGCTTGAGAA	ONE_NON-GENE_SITE_207
GGGTGAGGGCATATTTAGTGAGG	ONE_NON-GENE_SITE_208
TGTGTTAGAACAAACGCCACCAA	ONE_NON-GENE_SITE_209
AATGCCCCCCAAGGGTGTTTAAG	ONE_NON-GENE_SITE_210
CCTAGACCTATCTATGCTATGGG	ONE_NON-GENE_SITE_211
GCATAGGAGTGTCCGATTTCAAA	ONE_NON-GENE_SITE_212
ATTAAGGCCGTCTTAGCATCCTA	ONE_NON-GENE_SITE_213
CCCACGCTTAGTATAATACTGGC	ONE_NON-GENE_SITE_214
CAAGCATCTCGTGTGATCTTAAA	ONE_NON-GENE_SITE_215
TAGGTGCCAACTGCACTACCAGC	ONE_NON-GENE_SITE_216
CCTTAGTGTGCTAGTGCCCAATA	ONE_NON-GENE_SITE_217
GCTAATCGGTGCTTTCCTACAAA	ONE_NON-GENE_SITE_218
TGAACCTAACTACCATAACGAAG	ONE_NON-GENE_SITE_219
AACCGTAAGCCAGTAATACAGAT	ONE_NON-GENE_SITE_220
GAGGAGTGACCCGATCCTAGGAT	ONE_NON-GENE_SITE_221
CAATGACGCTTAATGTGTATCCA	ONE_NON-GENE_SITE_222
AGACTGTACCCCATAGCGGTAGA	ONE_NON-GENE_SITE_223
CTCCGAAGGCAAATCATTGGTAT	ONE_NON-GENE_SITE_224
CTTCCCCCGTGATAATATAGAAA	ONE_NON-GENE_SITE_225
CCAATCTAGGAATCTAGACTAGT	ONE_NON-GENE_SITE_226
TGGCTATGCACCCAACACGGTAC	ONE_NON-GENE_SITE_227
CCAGGCTAACATACGTCGTAACT	ONE_NON-GENE_SITE_228
CTGAAGATAGGCGTATATATATA	ONE_NON-GENE_SITE_229
AGTTTAAATTAACCCCCCCCCCC	ONE_NON-GENE_SITE_230
CCCTTGATAATTCGATTGGATTA	ONE_NON-GENE_SITE_231
CAGACTATGGCTCAATCTACAGT	ONE_NON-GENE_SITE_232
AGCTACATTCGCTAATCTTAATA	ONE_NON-GENE_SITE_233
CATGTGTCTCCGTATATAGCTTC	ONE_NON-GENE_SITE_234
GGGTCGATGATGTAATCACCTCA	ONE_NON-GENE_SITE_235
ATCCACGGTCAGTCGATGAGCTA	ONE_NON-GENE_SITE_236
GGTAGACTAATTGTGATCAGTTT	ONE_NON-GENE_SITE_237
GGAATTACGAATCTATAACAATG	ONE_NON-GENE_SITE_238
AACACTGACGCTTGCTACTTATC	ONE_NON-GENE_SITE_239
ACGGTAGTCTAAGTTCACTCAAC	ONE_NON-GENE_SITE_240
AGGGTAGTAGACCCTCAATAAAT	ONE_NON-GENE_SITE_241
CGTAACCTAATAGGCATTGTGAT	ONE_NON-GENE_SITE_242
ACAGGCATTATCGCATGGAGGGC	ONE_NON-GENE_SITE_243
AGTACTAAAGTAGGGTGTAAATA	ONE_NON-GENE_SITE_244
AGCACGGGCCTTAGTGATAAACT	ONE_NON-GENE_SITE_245
TAGAGTATAATTGTCGAACAGTC	ONE_NON-GENE_SITE_246
TCATATCGCTACCAGGTGAGGCT	ONE_NON-GENE_SITE_247
GGGGTACCCAACTATACTTACAC	ONE_NON-GENE_SITE_248
GCCATAAGGAGCGGTCATTCAGT	ONE_NON-GENE_SITE_249
CGTGTGAACTTACAATATGGTTT	ONE_NON-GENE_SITE_250
GTACCGATCATGCCTTGGCTACT	ONE_NON-GENE_SITE_251
TCACCACCGCTATATTACTGTAA	ONE_NON-GENE_SITE_252
GGTTTATTAGAACTGACGCATGG	ONE_NON-GENE_SITE_253
TTGACGGGCTGGATAGTACATAT	ONE_NON-GENE_SITE_254
TACGAATGTTAGGGAAGGCAATT	ONE_NON-GENE_SITE_255
TCCGTTGCTAATCCGTAACTCCA	ONE_NON-GENE_SITE_256
ATCTAGTATGCATAATGGCTAGC	ONE_NON-GENE_SITE_257
TTCTCGCTACTCTACTAGAATGT	ONE_NON-GENE_SITE_258
GACCCCTCATGTCAAATTATTCT	ONE_NON-GENE_SITE_259
AGATGCTCTGATACCCTACTTAT	ONE_NON-GENE_SITE_260
CGTCAATCAGTCAGTATGCAGAG	ONE_NON-GENE_SITE_261
TATGGTTAGCACCAATGCCTTCC	ONE_NON-GENE_SITE_262
CGGGGAATAAACAACTATTCTGG	ONE_NON-GENE_SITE_263
AATCTGTGTCACGAGACTCTGAC	ONE_NON-GENE_SITE_264
CGGTGAGTATACATGTAGGTTTA	ONE_NON-GENE_SITE_265
GTTGTAATAAAGTTCGCTCTAAG	ONE_NON-GENE_SITE_266
ACGGGATAGTGGAATTACAGCTG	ONE_NON-GENE_SITE_267
TCTAGAGGCGAGTAGTTTCCTGT	ONE_NON-GENE_SITE_268
GTACCATTAGCGTTCTGAACTTT	ONE_NON-GENE_SITE_269
GCTAATCTAAGCTGGCTCCTCTG	ONE_NON-GENE_SITE_270
GGTAGTCCTTACATGCCTACTTC	ONE_NON-GENE_SITE_271
TATTAAGCGGCTTCAGTATTTTC	ONE_NON-GENE_SITE_272
CTGATACACCGTTCTATCACTGC	ONE_NON-GENE_SITE_273
AATCAGACCATTGAGTCGAGTTC	ONE_NON-GENE_SITE_274
AGGTTCTCAGATTAATCGGAACT	ONE_NON-GENE_SITE_275
AAGCCCGTACTTTAGGATATAAG	ONE_NON-GENE_SITE_276
TGTGCTATGAGTATCGCAGACCA	ONE_NON-GENE_SITE_277
ATCGTCAGTTTTACACTACTGAG	ONE_NON-GENE_SITE_278
CACTATGTGGGACTATAACAGGA	ONE_NON-GENE_SITE_279
GTTAGTGTGCTAAGCTCAGTTTT	ONE_NON-GENE_SITE_280
CTCATAGTAACCGTAACAAAAGG	ONE_NON-GENE_SITE_281
GTCTGCAAGATTAGTCGAGTCTG	ONE_NON-GENE_SITE_282
ATAGATAGCACCGTAATATAAAT	ONE_NON-GENE_SITE_283
GACTCAATTAGCTAAGTTGTCTG	ONE_NON-GENE_SITE_284
ACCATGCAACGCACTCCAACAAT	ONE_NON-GENE_SITE_285
ACACTACTAGACTAGCCCTACAA	ONE_NON-GENE_SITE_286
CCCAAGATGGATCGTACTCAGAG	ONE_NON-GENE_SITE_287
CTATAGGGGCATCACGGGGATTT	ONE_NON-GENE_SITE_288
CCTACGGGCATAGAACATTTGAT	ONE_NON-GENE_SITE_289
AGCGATGTTTACTACTGCATACT	ONE_NON-GENE_SITE_290
TGAACACTTATACGTGGTATTTT	ONE_NON-GENE_SITE_291
TAGCTTAACCTTACTCCACACAA	ONE_NON-GENE_SITE_292
GGACCGTGTCAACCATAGATTCT	ONE_NON-GENE_SITE_293
ATATTCTAGCGTCATGATAAATG	ONE_NON-GENE_SITE_294
GTCCTAGGGAGTATCACTCTTTT	ONE_NON-GENE_SITE_295
ACGTGTCTAGAGTTACAACACTG	ONE_NON-GENE_SITE_296
CGATCTAGGTGCTCATTTCCTCT	ONE_NON-GENE_SITE_297
CTGACAATAGACGTCCTTGATCT	ONE_NON-GENE_SITE_298
GAAACGGCCAGATATGGTCCCAT	ONE_NON-GENE_SITE_299
TACACGTATAGGTTGTGACTTAA	ONE_NON-GENE_SITE_300
TAGTAATGTAGGCGTTAACCAAA	ONE_NON-GENE_SITE_301
CAATAACGTGTCAGTACAAATGA	ONE_NON-GENE_SITE_302
GGTATCCTACAGAATCCCTAACT	ONE_NON-GENE_SITE_303
TGACAGTATAAGCATCGTTCTCA	ONE_NON-GENE_SITE_304
TGTACCACGGTGAACCATTTCCT	ONE_NON-GENE_SITE_305
CTTAGCCTAAGTATGCTATTATT	ONE_NON-GENE_SITE_306
GATTCAATGTACTAGGACCTGAC	ONE_NON-GENE_SITE_307
CTATCCGGTGATGAGTTGTGTGG	ONE_NON-GENE_SITE_308
ACTTTACCTTAGCCTAAGCTCTA	ONE_NON-GENE_SITE_309
AGGGTATATCGGTGTGAGCTAAA	ONE_NON-GENE_SITE_310
GTTAACTACCAATCCTATCACAC	ONE_NON-GENE_SITE_311
AGGGTTTACTAGTGTCATAAAAT	ONE_NON-GENE_SITE_312
ATGGTCTATAGACGCATGAAAAT	ONE_NON-GENE_SITE_313
ACAGTGTGACGATTATTAGTAAC	ONE_NON-GENE_SITE_314
CACTAGGCTGGCATACAACTGAG	ONE_NON-GENE_SITE_315
GGGAGTCCAACTTAAGTTGTTGC	ONE_NON-GENE_SITE_316
GCCGGGTATTCTCCTATTACCCC	ONE_NON-GENE_SITE_317
GGGTTTGTACTATAACAGTGTAC	ONE_NON-GENE_SITE_318
GTGGAAACGGGATACGTCGCCAA	ONE_NON-GENE_SITE_319
ATAATGTGACTTAGGTACGTTTG	ONE_NON-GENE_SITE_320
AGGTGCACATAAGGGCGATTCTG	ONE_NON-GENE_SITE_321
TGATACGAGGTTTAAGATAGTCT	ONE_NON-GENE_SITE_322
ATCGGAGCTATTGGGAATCAATG	ONE_NON-GENE_SITE_323
CTTCCTTCGGATAAGCTAAACAT	ONE_NON-GENE_SITE_324
ACTAAGAATCCATCGGGGAGATG	ONE_NON-GENE_SITE_325
CATATTGTCGTCCTGTATAGAAT	ONE_NON-GENE_SITE_326
CGTAATCGAAGTTTCACATCAAG	ONE_NON-GENE_SITE_327
CTGATAGTAAACCCCTTACGAGT	ONE_NON-GENE_SITE_328
CGTGGATATGGTATATTGACATA	ONE_NON-GENE_SITE_329
CTAGACAGTCAGTACCCTACTTA	ONE_NON-GENE_SITE_330
ACCTACACCGATAAATCCTTGTT	ONE_NON-GENE_SITE_331
GGGTACAATATGTTAGTGGAAGA	ONE_NON-GENE_SITE_332
TTAGAGCCAGTGATACGGTTTGG	ONE_NON-GENE_SITE_333
ATTGCCAGTGGTAGTCGACAGCA	ONE_NON-GENE_SITE_334
CAACATCTCGTAAGTGATTAATC	ONE_NON-GENE_SITE_335
TAGAGACTAGACATCTGGCTTAG	ONE_NON-GENE_SITE_336
GGACTACCCTGATGTAAGGCTCT	ONE_NON-GENE_SITE_337
GTGAGGTTAGCGGTAATACTAGC	ONE_NON-GENE_SITE_338
ATTACTCTTACGCTGACTATTGA	ONE_NON-GENE_SITE_339
TTGGACGTCTCCTAACTTCATAT	ONE_NON-GENE_SITE_340
TGCATTAGACGCCTAAGGCAAAT	ONE_NON-GENE_SITE_341
CTTATCTGATACGGTCAACATTA	ONE_NON-GENE_SITE_342
AGTCACTCAATCCTGATCGTTCT	ONE_NON-GENE_SITE_343
TGTCCAATCTAGTAGACCTTGTG	ONE_NON-GENE_SITE_344
GGGTTATTGACTTAGAGGCCACA	ONE_NON-GENE_SITE_345
ACCGAGCGTATATGTTCAGAGTC	ONE_NON-GENE_SITE_346
CATGTAGCACTACCATGACAGTG	ONE_NON-GENE_SITE_347
CTGCGATATCTAGACTCAACCCT	ONE_NON-GENE_SITE_348
CTATAGTTAACACGAGTCATCTA	ONE_NON-GENE_SITE_349
ATTAGTAATGCCCTTCGCATGTG	ONE_NON-GENE_SITE_350
CACTTATACTATGGGTAACCCAG	ONE_NON-GENE_SITE_351
GAATTGAATCCTCGCGTATTGCT	ONE_NON-GENE_SITE_352
TAAGGGCGTAGGGAATAGAGAAG	ONE_NON-GENE_SITE_353
GGAATGTCTAGTCATACCCCAGC	ONE_NON-GENE_SITE_354
ATAGAGACTCGTTCCATACTAAA	ONE_NON-GENE_SITE_355
ACCGAGTTAGCCGAGTTAGCCAG	ONE_NON-GENE_SITE_356
AATCCGACTTGATCTATAGCCCC	ONE_NON-GENE_SITE_357
TGTGCATCAACCGACCCGATTGG	ONE_NON-GENE_SITE_358
GGGTGGGTTAATGTACGCTTTTT	ONE_NON-GENE_SITE_359
GTTTGGCGGTATAGAACTTTAGC	ONE_NON-GENE_SITE_360
GTCTATGTGTATCCGTACCAGTA	ONE_NON-GENE_SITE_361
CCCATCACAATAGGTGTATAGAC	ONE_NON-GENE_SITE_362
CGTTCAGGACTTAACCTAGAGAA	ONE_NON-GENE_SITE_363
CATTTACCAGTCATAAACGATAT	ONE_NON-GENE_SITE_364
TCTAGACCTGTTAATAGGTAGGA	ONE_NON-GENE_SITE_365
AAGATAGTCGTAGTGAGTTCTAG	ONE_NON-GENE_SITE_366
GAGTTAATGTGCGTCACTGTTGT	ONE_NON-GENE_SITE_367
ACTCTAAATACGATTGAGAGCAG	ONE_NON-GENE_SITE_368
TACTGTACTAACACCCTTAAGTT	ONE_NON-GENE_SITE_369
GGGCAGGGTTAAACACAATTATT	ONE_NON-GENE_SITE_370
GAGCTAACACCCCGGTTACTAAG	ONE_NON-GENE_SITE_371
ATCTATACCAGACCCCTACTACA	ONE_NON-GENE_SITE_372
AGGTGGTGAATAGACGATATTGT	ONE_NON-GENE_SITE_373
GATATGCGACTCATCAGACATTG	ONE_NON-GENE_SITE_374
GCAATGATAGCCACTTAGCCCTT	ONE_NON-GENE_SITE_375
ACTGAGTACCGATATACACCCTA	ONE_NON-GENE_SITE_376
TCTGACGTCTATATGACAGTGGT	ONE_NON-GENE_SITE_377
TATAGACACCCCTACTGTTTACC	ONE_NON-GENE_SITE_378
GTGCAGCGTACACGTAATGTGAA	ONE_NON-GENE_SITE_379
CACCGTAGGCAGAATGTTATTAT	ONE_NON-GENE_SITE_380
TACCCAAGTAACGTTGTATTTTA	ONE_NON-GENE_SITE_381
ATCGGCCGACCTGCGCTTTCCGC	ONE_NON-GENE_SITE_382
TGTACAAACGCGAATAGGCATTC	ONE_NON-GENE_SITE_383
CATACGACCCTGAGTCTACAGAC	ONE_NON-GENE_SITE_384
CCGTGAGTACAATTGCACTTAGC	ONE_NON-GENE_SITE_385
TGTCCGATGGTAGGCACTCACTT	ONE_NON-GENE_SITE_386
GTAATACCCAGGAGTCATAATGT	ONE_NON-GENE_SITE_387
GTAGATATCCCTATAGAACATTT	ONE_NON-GENE_SITE_388
TGCTATACCGCAACAGACTGTAA	ONE_NON-GENE_SITE_389
AGTTACATCGACCTACTTGTATA	ONE_NON-GENE_SITE_390
GGGATATCACCAGTAGAATATAA	ONE_NON-GENE_SITE_391
ATACGTCTAGGCATAATGTGGGG	ONE_NON-GENE_SITE_392
CAGTAGCCTAGGGTCATTAAGAT	ONE_NON-GENE_SITE_393
TGTTCCCTAATATGGCCGGTTTT	ONE_NON-GENE_SITE_394
GTTGATCAACACCGGTGTTGTTG	ONE_NON-GENE_SITE_395
ACTCTAAGACGCAGGATAGCAGG	ONE_NON-GENE_SITE_396
GTCTACACTAGCGACTGGATAAA	ONE_NON-GENE_SITE_397
CTGGTCGTCTAATATGCACCCCT	ONE_NON-GENE_SITE_398
GCACTAGCAGGCGAATTCTTCAA	ONE_NON-GENE_SITE_399
ATGCGCCCATTGTGTGTATGTGT	ONE_NON-GENE_SITE_400
GAACGTTGCTATTCAACTACTGA	ONE_NON-GENE_SITE_401
AAAAGCGCATACAACTATCACAT	ONE_NON-GENE_SITE_402
CGCTATACGCATGGTACATCTTT	ONE_NON-GENE_SITE_403
GTAGAGATGCCCTGCTAATTTTT	ONE_NON-GENE_SITE_404
AGTATACTCCTGACGGGAGGCAA	ONE_NON-GENE_SITE_405
ACCCTAGAACTAGTCGCATCATG	ONE_NON-GENE_SITE_406
GTCGATGATCTAATATAGCCCTT	ONE_NON-GENE_SITE_407
AGGCCCCACAACGATTGAATCAG	ONE_NON-GENE_SITE_408
GTTAACCCTACGAGTGAGAGAAT	ONE_NON-GENE_SITE_409
GTGTTAGTTTACAATCGGTTGCA	ONE_NON-GENE_SITE_410
ACTGACATCAACGCTAGTTACAG	ONE_NON-GENE_SITE_411
CTCACTCTAGTCGTAGTAAACTT	ONE_NON-GENE_SITE_412
ATAGAGAGCATTCGACCACTGGT	ONE_NON-GENE_SITE_413
TATATGCCACTAACGTAGCAGCT	ONE_NON-GENE_SITE_414
ATTGACCCTCTAGTACGTCACAA	ONE_NON-GENE_SITE_415
AAAGTACAGACCCCGGTTGGAGG	ONE_NON-GENE_SITE_416
TATAGGGCAACTTGTGCATCCAG	ONE_NON-GENE_SITE_417
GTTCGAAAGCGACTGGGTAAAAT	ONE_NON-GENE_SITE_418
CCTATGTTGTCTAACAACCTTAG	ONE_NON-GENE_SITE_419
CGACCGTTTACCAGTGTATTCCC	ONE_NON-GENE_SITE_420
AGGTAATTAGTACGTTAAGACTA	ONE_NON-GENE_SITE_421
CTCAACGTTGTACCAGTTACAAA	ONE_NON-GENE_SITE_422
GCCTCTACACAAGAACGGATAGG	ONE_NON-GENE_SITE_423
TAGTGTTAGTCCATAACTCATAG	ONE_NON-GENE_SITE_424
TCTACCTACCCCGTGATGTCCTT	ONE_NON-GENE_SITE_425
CTTAGGTACTAAAAGCCCCACAA	ONE_NON-GENE_SITE_426
GATCTGTCCTATCCGGTATTTTT	ONE_NON-GENE_SITE_427
CCTACGTCTTTGTTCGATATGCA	ONE_NON-GENE_SITE_428
GAACAGGATATGTAGTCCGTGTG	ONE_NON-GENE_SITE_429
TAGCAATCTAGCATACTCCTAGA	ONE_NON-GENE_SITE_430
ACGGAGCTACTACTACATTCCAG	ONE_NON-GENE_SITE_431
ATTACGTGCCCCCATAATCGCCC	ONE_NON-GENE_SITE_432
TAGGGAAAACTGCTGACCGTAAA	ONE_NON-GENE_SITE_433
GGCATCGACCTAAATAATGATGG	ONE_NON-GENE_SITE_434
TCCCTAGTGTTAGAATACCAGTG	ONE_NON-GENE_SITE_435
CCATAAGGTTCGTTGGGATATGC	ONE_NON-GENE_SITE_436
GTGTACTTATGGCATACTCATCT	ONE_NON-GENE_SITE_437
CTGAGCCACGTTAGAGTTTAATA	ONE_NON-GENE_SITE_438
AGTGCCTACGAATAAGCAATTAA	ONE_NON-GENE_SITE_439
ATAAGACTCGTTGGAGACAGATG	ONE_NON-GENE_SITE_440
GTAGATAGGTGGACAAAGCCCAA	ONE_NON-GENE_SITE_441
CGCTAACAAATACTCTTGGAATA	ONE_NON-GENE_SITE_442
GTTTGCCGTAAACGAAAGTACGT	ONE_NON-GENE_SITE_443
CGCATACCATGGACCTGATTATT	ONE_NON-GENE_SITE_444
TTGTCTAGTGAGCTACTAACCCT	ONE_NON-GENE_SITE_445
ACCGTCTAGCACTAAGAGAACAA	ONE_NON-GENE_SITE_446
TACAGTGTATCCGCTATAACCTC	ONE_NON-GENE_SITE_447
ACGTGTGCATAAGGCAACTTAGA	ONE_NON-GENE_SITE_448
GTGAGTCTTCGACTCCATACACA	ONE_NON-GENE_SITE_449
CGTCACCAGAATTGAGCATTCAT	ONE_NON-GENE_SITE_450
GTTGAGTTAGGTTACAAGGTTCT	ONE_NON-GENE_SITE_451
CTACCTATGGTTATACCATCCAT	ONE_NON-GENE_SITE_452
CTAAGTGGTGACTTAGTACCATA	ONE_NON-GENE_SITE_453
GTACCTATGATAAAGGGGCAGAA	ONE_NON-GENE_SITE_454
TGCACCCTAATAGTGCTACGTAG	ONE_NON-GENE_SITE_455
CCGCAAGGTTCTACTATACCTGG	ONE_NON-GENE_SITE_456
CCCCCTAGGATACAAAATCTATT	ONE_NON-GENE_SITE_457
TCCATGATCGAGTCTAATTTCCA	ONE_NON-GENE_SITE_458
CCTAAGTCTACTTAGCTAGTAAG	ONE_NON-GENE_SITE_459
ACAACAGCGGGTGCATAGACCAC	ONE_NON-GENE_SITE_460
TAGCTAGTAACCTTGACTGAGGA	ONE_NON-GENE_SITE_461
GATACCTCAATAGTTTCCGGGGT	ONE_NON-GENE_SITE_462
AATTCAATGGGTGGTACGGTTTG	ONE_NON-GENE_SITE_463
ACTTGTAAGGTTCGATACGCACA	ONE_NON-GENE_SITE_464
CGTGGATCATAAGGTTAACATCC	ONE_NON-GENE_SITE_465
GGACCTAATTCATGACTATATAT	ONE_NON-GENE_SITE_466
TCGTTACTATGCAGACAGTATGT	ONE_NON-GENE_SITE_467
CGCTAAGAACAGACGTTTAAAAT	ONE_NON-GENE_SITE_468
AGACGACAGCCGTCTCATAATGA	ONE_NON-GENE_SITE_469
TAACCAGCTAACAAGTCCGCTCT	ONE_NON-GENE_SITE_470
GGCTACAACGGCATAACTGAGTA	ONE_NON-GENE_SITE_471
CCGAGACTAACACCTTTAAGATT	ONE_NON-GENE_SITE_472
GAATCGTCCAGGTAAAACGTTGC	ONE_NON-GENE_SITE_473
AGTGTGGTTCCCCTACTTATCAG	ONE_NON-GENE_SITE_474
GGGTAGGCTTCGTGATTAGGAGT	ONE_NON-GENE_SITE_475
GGCCCTTGATCAATACTACTTGG	ONE_NON-GENE_SITE_476
TAAGAGATAGCTAGCTACCAGAA	ONE_NON-GENE_SITE_477
GTAGCATTGCGGGTTTGTTCCAC	ONE_NON-GENE_SITE_478
GGAAATACGCTAACTTAACCAAC	ONE_NON-GENE_SITE_479
TATGACCCCTATCAATCCTTTCG	ONE_NON-GENE_SITE_480
ACCGATACTGGTTTATGGTTCTT	ONE_NON-GENE_SITE_481
CATGTAACGACCCATTAAATCCT	ONE_NON-GENE_SITE_482
ACGTTAGGATGCTCATAATTAAT	ONE_NON-GENE_SITE_483
GGCCCTGCACGTCTCATTAGTGG	ONE_NON-GENE_SITE_484
GGTTAGAGGAGTTATAACCATCT	ONE_NON-GENE_SITE_485
AGACAGCATGATGCGACTAGTTC	ONE_NON-GENE_SITE_486
GGGTGCCTAAATGTATTGGCAGG	ONE_NON-GENE_SITE_487
CTCGACTAATCTAAGCTTAATAC	ONE_NON-GENE_SITE_488
ACAGTCGGGCTGCAAATCGCTCC	ONE_NON-GENE_SITE_489
GAACCCACTAGACGTGTGACCTA	ONE_NON-GENE_SITE_490
GGGTTTAGGTTTACACATCTAAA	ONE_NON-GENE_SITE_491
TAAGTGGAATCCGTTACTCTATT	ONE_NON-GENE_SITE_492
ACGACGCATTATAAAAAGAGAAC	ONE_NON-GENE_SITE_493
AGGCATGTAAGTCGTCCCTCCTC	ONE_NON-GENE_SITE_494
CTCACACAGGACCGTTGAATATG	ONE_NON-GENE_SITE_495
GTGCGGACGGACTTGACAACCCG	ONE_NON-GENE_SITE_496
ACCCAGTACGTAAGTTAACACCA	ONE_NON-GENE_SITE_497
TAGAGCTATAGACGGACAGAGTG	ONE_NON-GENE_SITE_498
GAATATCCCCCATTAGGTATAAA	ONE_NON-GENE_SITE_499
GCGTCTAATCTCTGGGAAAGAAT	ONE_NON-GENE_SITE_500
GGAGTAGAAAGTCGTAAGGCCAG	ONE_NON-GENE_SITE_501
GACGTAGCCAGCATATGAAGAAG	ONE_NON-GENE_SITE_502
GGATCCCAAGTGTACCACTTCCT	ONE_NON-GENE_SITE_503
CTAGGATCCACGCCATTAGTGTC	ONE_NON-GENE_SITE_504
GCTAATAAAAGCTCGCTGCAGCC	ONE_NON-GENE_SITE_505
CGTGTATCGTAGGTTTAATTAAA	ONE_NON-GENE_SITE_506
TGAGGTACCCTACACCGATAATA	ONE_NON-GENE_SITE_507
TATCATAGCATGACTACCCATTA	ONE_NON-GENE_SITE_508
ACTATGAGCAAAGCGTTACAATT	ONE_NON-GENE_SITE_509
CTGTTACGCGCGGTCGCCCTCTA	ONE_NON-GENE_SITE_510
CATGTAAGGTAGCTAGACATCTA	ONE_NON-GENE_SITE_511
CTACTATCAGATCACGTGCTTTA	ONE_NON-GENE_SITE_512
GTCTTAGATGGTTCTACTATTTT	ONE_NON-GENE_SITE_513
GTGGGCGTGCTAAAATCATTGAG	ONE_NON-GENE_SITE_514
AGCGTCCCTAATCCTATCTCACA	ONE_NON-GENE_SITE_515
GTGGTGCTACGGAGGGTTAGCAT	ONE_NON-GENE_SITE_516
GTGACGTGATATCCTGCTATTTC	ONE_NON-GENE_SITE_517
AAGGTGATAGCCGTAGTCAGAAT	ONE_NON-GENE_SITE_518
GTCTGCTAAGGACGGCATAATTA	ONE_NON-GENE_SITE_519
TACCAGACGCTAAACCATATTTG	ONE_NON-GENE_SITE_520
GAGCAACCAGTTAACCAGTATCA	ONE_NON-GENE_SITE_521
GATATACTAGCATTGGGGGACTA	ONE_NON-GENE_SITE_522
CTAGAGTATCTAATCGGGATCTT	ONE_NON-GENE_SITE_523
CTAAGCTCACATTATGATCTAAA	ONE_NON-GENE_SITE_524
TACATCCCCTACTAGGTTGCATA	ONE_NON-GENE_SITE_525
ATATGGGGCACTGGTCGCTCTTC	ONE_NON-GENE_SITE_526
TAATCCGCCAATCATACTGCAGG	ONE_NON-GENE_SITE_527
GTAGCCATGTACGTAGGCAGCTT	ONE_NON-GENE_SITE_528
CCGCTATCATAGGAAGGCAGGCT	ONE_NON-GENE_SITE_529
TACGTTATCCAACTATGTAAGTC	ONE_NON-GENE_SITE_530
AACATGGGACTCGATAATAGTGT	ONE_NON-GENE_SITE_531
TGCCTATTAGCAAACGTCTCAGG	ONE_NON-GENE_SITE_532
CTTCGAACTGAGAGCTTGCTTCA	ONE_NON-GENE_SITE_533
AATCCTCTATGATATACGGCTAG	ONE_NON-GENE_SITE_534
ATCCGGAATCCGCATATCACCTA	ONE_NON-GENE_SITE_535
TTGACGGACGGTGAAAACTCTTT	ONE_NON-GENE_SITE_536
GCATGTTTACTATTATCCGCTTA	ONE_NON-GENE_SITE_537
ATCTTGACTCTACCAACGTTTTT	ONE_NON-GENE_SITE_538
ATAAGAGTAGCCAACCCCCAAAG	ONE_NON-GENE_SITE_539
ACCTTACCTAAATACCCCCACAT	ONE_NON-GENE_SITE_540
GTATGCAGTAGGGCCCTTTAATC	ONE_NON-GENE_SITE_541
TACTAGGTACATAGGCTCGACAT	ONE_NON-GENE_SITE_542
GCGTGTAGCTTTATGGTTACTCG	ONE_NON-GENE_SITE_543
GTGGACCCTAATAGCCCTATAAA	ONE_NON-GENE_SITE_544
CCCACTATAGTCAGCGCTTCAAT	ONE_NON-GENE_SITE_545
AGGCAACCCTATGCAGGTTAATC	ONE_NON-GENE_SITE_546
GTTAGCCAGTATCGAATCTATGA	ONE_NON-GENE_SITE_547
TAGCAAGTTGACGATATTCCCTT	ONE_NON-GENE_SITE_548
GCCCGGACTAAATCCGACTGAGA	ONE_NON-GENE_SITE_549
GGTCAAAATGCCGTGTCAGTGTG	ONE_NON-GENE_SITE_550
TGAGAGCTACCCGACCTAAAAGT	ONE_NON-GENE_SITE_551
CTATCGAAAGGCATGTTTGCAAA	ONE_NON-GENE_SITE_552
ACATATTGTACCGTAGGCCCAAT	ONE_NON-GENE_SITE_553
GCCATACGGTTTAGACACGGGAC	ONE_NON-GENE_SITE_554
GTTAACCAATTGACTTGAGCTCT	ONE_NON-GENE_SITE_555
TGACCCCTACATATGGAATTTCT	ONE_NON-GENE_SITE_556
ATCACGCTAAAACACACTATCAT	ONE_NON-GENE_SITE_557
ATAATCCGACCAAGGCACAGTTG	ONE_NON-GENE_SITE_558
CAGTACACTAGTAACCTAGGGAC	ONE_NON-GENE_SITE_559
CCGCTATTGCTAGAGGTTTGGTA	ONE_NON-GENE_SITE_560
GAATAGTAAGACGGATTGGTACC	ONE_NON-GENE_SITE_561
AATAGGGCATATACTGTCCAATT	ONE_NON-GENE_SITE_562
TAGTAAGCGCAAACTAGTTAAGA	ONE_NON-GENE_SITE_563
CCATGTGTAGTGCGACAGCAAAA	ONE_NON-GENE_SITE_564
CCTATTGCCCAATGGTTTATAAA	ONE_NON-GENE_SITE_565
CGATCCATTAGAGTGCCTATCCC	ONE_NON-GENE_SITE_566
CCCACCTAACAAAGCGAGATTGA	ONE_NON-GENE_SITE_567
TACTACTAGTACTAGAGGGAGAA	ONE_NON-GENE_SITE_568
TAACCCGCTATGCACCATAGTCA	ONE_NON-GENE_SITE_569
CATGACACGTTAGTGTTTCCTTC	ONE_NON-GENE_SITE_570
CCCTGAACCTGCACGGTTAATTT	ONE_NON-GENE_SITE_571
CGATACCCGGTAGGTTGTGGTAT	ONE_NON-GENE_SITE_572
CGTAGGCGGTTTCAATCTCAATT	ONE_NON-GENE_SITE_573
ATACCCGGTAGGACATATTTTCC	ONE_NON-GENE_SITE_574
CATGGTTGAGGCTAACCGCATCT	ONE_NON-GENE_SITE_575
CCGAGTTATCTAACATCAACCAA	ONE_NON-GENE_SITE_576
TCGATAGGGTTACTAAACTGGTA	ONE_NON-GENE_SITE_577
ACCCCGTTTGATCTGTTCATCAG	ONE_NON-GENE_SITE_578
CGTGATATAGTAACCTCGGAAGT	ONE_NON-GENE_SITE_579
GTAAGCCGTACTCTAGAATTTTT	ONE_NON-GENE_SITE_580
GCTCCTAACGGTCAAGAATTGAC	ONE_NON-GENE_SITE_581
CAATGCATAAAGCACGTCCACAC	ONE_NON-GENE_SITE_582
CAGAAAATCGTACCTCGTATTAT	ONE_NON-GENE_SITE_583
AATCGAAATGGAGACGTATTCAA	ONE_NON-GENE_SITE_584
GAAACCTTAACCTCGTCACTAAA	ONE_NON-GENE_SITE_585
CTCTCGGGTCAATATGTATCTTT	ONE_NON-GENE_SITE_586
ATCGTGGAGGTTAACTGATTCTG	ONE_NON-GENE_SITE_587
TAGGTCTGACAAGTGTGACCTTT	ONE_NON-GENE_SITE_588
ATACGGACACCTAACTAGAAGAG	ONE_NON-GENE_SITE_589
GGTGCGAAGTATCATCTAAGACA	ONE_NON-GENE_SITE_590
GAGTCTAGCCATTGAGACACACC	ONE_NON-GENE_SITE_591
GTTATATGATACAGCGCTTTCGG	ONE_NON-GENE_SITE_592
TATGACGGTATATACCAACTTAA	ONE_NON-GENE_SITE_593
GTGGGGATGTATTACGAAGGGTG	ONE_NON-GENE_SITE_594
TGATGACACGTTATGTATGCCAA	ONE_NON-GENE_SITE_595
TTGGGTGAGGCATACGTACCTGA	ONE_NON-GENE_SITE_596
TACTTATACTAACCCATGCTAAA	ONE_NON-GENE_SITE_597
TAGACCTAACCAGTACATAATGG	ONE_NON-GENE_SITE_598
TCCGGGGTCAGTATAGAGTAACA	ONE_NON-GENE_SITE_599
TACTTAGGTATGTCTAGTGAATC	ONE_NON-GENE_SITE_600
GCGAATGTGCGTTGAGTTCTTAC	ONE_NON-GENE_SITE_601
ATAGCGGGGTAAGTCTGATCTCA	ONE_NON-GENE_SITE_602
TATAGGTATGCTAGCTGAAAATA	ONE_NON-GENE_SITE_603
CTGATCCTATGGGTTAGGCATCT	ONE_NON-GENE_SITE_604
CATATAACAATGACGCACCTAGA	ONE_NON-GENE_SITE_605
AATCAATATACACGACGATGCTT	ONE_NON-GENE_SITE_606
ATTAACCTACACTCGCTAAGGAC	ONE_NON-GENE_SITE_607
ATGATTGTAAGTGGGACCGTATT	ONE_NON-GENE_SITE_608
CATGCCATACCGGCATGAATCGA	ONE_NON-GENE_SITE_609
CTTGATAACAGATATGCGCATTT	ONE_NON-GENE_SITE_610
CCCCTAAGGCTTTGGTAGTCTAG	ONE_NON-GENE_SITE_611
TCGTAAGAGACTCAGTTAGGAGT	ONE_NON-GENE_SITE_612
TGCTGAACCATAATGCGTTTGGA	ONE_NON-GENE_SITE_613
ACGACATCATAGCATGTATCAGT	ONE_NON-GENE_SITE_614
CCATTAACCTATCTCGTAATGAG	ONE_NON-GENE_SITE_615
AACGTATTAGGTCTGACCATTTT	ONE_NON-GENE_SITE_616
ATAGGGGCTCACTCAAATCTATT	ONE_NON-GENE_SITE_617
CACTTACGGTACTAATGTAAAAT	ONE_NON-GENE_SITE_618
ACTCGGATGTAATTACAGGAATA	ONE_NON-GENE_SITE_619
TACTACCTCTAATCAGGGCAATT	ONE_NON-GENE_SITE_620
TGCTTACACTAAGAACACGCTGA	ONE_NON-GENE_SITE_621
GATCGGTCTATACAGTGTGTTGA	ONE_NON-GENE_SITE_622
CCAAACCGTAATTGCTTGGCAAT	ONE_NON-GENE_SITE_623
ATACAACTATAGCTTACGATAGC	ONE_NON-GENE_SITE_624
AGGTGCCACTAGTAGGTCGGAAC	ONE_NON-GENE_SITE_625
TACTTGCATCGCACTTGCTACTG	ONE_NON-GENE_SITE_626
CTAACTCCGCATCCTGACGCATG	ONE_NON-GENE_SITE_627
GGGTACTCTAAGCTACCAAATTC	ONE_NON-GENE_SITE_628
ATAATGTACTGTTCCCACGGTTG	ONE_NON-GENE_SITE_629
AGCCATTATGTTCCGTATATATG	ONE_NON-GENE_SITE_630
TACCCGTATACCTGTCTACCTTA	ONE_NON-GENE_SITE_631
GCGTAAAACGACAAGTGAGATAA	ONE_NON-GENE_SITE_632
GACAGCATGATAACGAGGCTCCT	ONE_NON-GENE_SITE_633
ACAATAGTCAATGATCGTAGGAA	ONE_NON-GENE_SITE_634
GACTGTCTGACCCTATAGCCTTG	ONE_NON-GENE_SITE_635
GAGGATCATTAGTCAACACAGTG	ONE_NON-GENE_SITE_636
GTATAATCACACTATGACCAAGA	ONE_NON-GENE_SITE_637
ATGACTTAAGCCAAACGTGTTAA	ONE_NON-GENE_SITE_638
TCGGGGCCATGAAATATACACAT	ONE_NON-GENE_SITE_639
ATTAAGTCGATAGTGTACAAATG	ONE_NON-GENE_SITE_640
ACATAGTAGTCACTCCTCGATAA	ONE_NON-GENE_SITE_641
ACCGCTGCAATTATACTATAAAA	ONE_NON-GENE_SITE_642
ATAGTCGCTTAGTAGTAGTTATT	ONE_NON-GENE_SITE_643
TATACATCAACGCAGGGTGATAT	ONE_NON-GENE_SITE_644
GCCACGAGACTTGGTTTGCCCAA	ONE_NON-GENE_SITE_645
ACACGTGCTAGTGACAAAATGTT	ONE_NON-GENE_SITE_646
AGACACGATGTTGTAGCTACTTC	ONE_NON-GENE_SITE_647
TAAGATCCCTTAATTGCCGTACA	ONE_NON-GENE_SITE_648
CCGTAGATCCACACTTCTGCCAC	ONE_NON-GENE_SITE_649
GTATGATAACTCAAACCGGATAA	ONE_NON-GENE_SITE_650
GTAGGTATCGATAAATTTCTTTC	ONE_NON-GENE_SITE_651
AGACTTCCCAACTCGGTAATCTG	ONE_NON-GENE_SITE_652
CTCCCTAAAATTCCGTGGGTAGA	ONE_NON-GENE_SITE_653
TACAGAAGCTTCGATCTAATAAA	ONE_NON-GENE_SITE_654
CAATCCTTCGCTCCGGTCTATGA	ONE_NON-GENE_SITE_655
GCATTACAGTGGCTTACGAAGCA	ONE_NON-GENE_SITE_656
TTACCCACGGTGGGAGATAGATT	ONE_NON-GENE_SITE_657
ACCACCCTATCGAGTATGCAGTA	ONE_NON-GENE_SITE_658
CCACCTTGTCTAGCGATAGTGAC	ONE_NON-GENE_SITE_659
AGCTCAGTACTTATCGATAAGTC	ONE_NON-GENE_SITE_660
GAGTCGAAAACTGTTCTCCTCCC	ONE_NON-GENE_SITE_661
ACCGTAGATAGATAGCCCATGAG	ONE_NON-GENE_SITE_662
GATCCGTCATGCAATTAACTCAG	ONE_NON-GENE_SITE_663
ATAGCCTATACTGTCCCAAGAAC	ONE_NON-GENE_SITE_664
CTCGGTATCATAGGCAGCCTCTA	ONE_NON-GENE_SITE_665
CATAGAGTCGGGCCCATTCTACC	ONE_NON-GENE_SITE_666
TGAAGAGTCACGTTACACCCCAG	ONE_NON-GENE_SITE_667
TAGACTAGCCTACAAGATCATCC	ONE_NON-GENE_SITE_668
CCCCTGGTATTGCTAGACTAGCA	ONE_NON-GENE_SITE_669
CCGACAATAGGTTTGAAAAAGGA	ONE_NON-GENE_SITE_670
GTGCCGCTTCAAACCTAATTTAA	ONE_NON-GENE_SITE_671
GTACTAAGATGGCATAACGTTCA	ONE_NON-GENE_SITE_672
TGCACCCGACATACTGACATGTT	ONE_NON-GENE_SITE_673
ATACTGGCTCATGTACGCTTTAA	ONE_NON-GENE_SITE_674
GAACGTTCTGTAAAACGTGCAGT	ONE_NON-GENE_SITE_675
CTATATCTCGTGACACTTAGTTG	ONE_NON-GENE_SITE_676
ATCCATGCATATCGGCATCTGCT	ONE_NON-GENE_SITE_677
AATGCTACCCTATGACACTTGGG	ONE_NON-GENE_SITE_678
CAATCCTTAGGAGCAAACGCTTT	ONE_NON-GENE_SITE_679
ATACTGTGCACTATAGGGTTTTT	ONE_NON-GENE_SITE_680
GTCTAACCGCCAATTCACTCATT	ONE_NON-GENE_SITE_681
GTCTAAACTCCGCAAAAGAATAG	ONE_NON-GENE_SITE_682
GTACACGTACTGAGACCCGACGT	ONE_NON-GENE_SITE_683
CAGCTAGAAGGTAAATTCGAGGA	ONE_NON-GENE_SITE_684
AGGATCGGATCTGATGAATCAAC	ONE_NON-GENE_SITE_685
TAGGTACTGAACGTACCGAATAA	ONE_NON-GENE_SITE_686
CTCTAGCCCTCGTATATCTGCAG	ONE_NON-GENE_SITE_687
TTATCCCTAGCTAGTATGACTCA	ONE_NON-GENE_SITE_688
CGTGTCTATGCACAAGAATAATT	ONE_NON-GENE_SITE_689
AATACCTCAACCACATTCGGGCT	ONE_NON-GENE_SITE_690
ATTAGACGTAACTATCACTTTAA	ONE_NON-GENE_SITE_691
CCATAAGGTATGGGCTAACAATT	ONE_NON-GENE_SITE_692
CGGTAGTTCATATATCCTTTAAT	ONE_NON-GENE_SITE_693
TAGACTCCTGGTATGAGACAGAG	ONE_NON-GENE_SITE_694
AAACCATTAGGATCAGTACCTCT	ONE_NON-GENE_SITE_695
GGGCATACGAATGCCATTTCACT	ONE_NON-GENE_SITE_696
TGACTAAGCCTTAATCGTGATTT	ONE_NON-GENE_SITE_697
TGTTAGGTGCGTGCAATTTACAT	ONE_NON-GENE_SITE_698
GTTGCTGCTCGCATGATATATCT	ONE_NON-GENE_SITE_699
GTAGAACTAGTCACTTGACCCTA	ONE_NON-GENE_SITE_700
GTATCCAACTGGTGTAGACACAG	ONE_NON-GENE_SITE_701
TGACGTAGGCACAATACTAACTT	ONE_NON-GENE_SITE_702
GGGTTATCTTTCTACACGGCAGA	ONE_NON-GENE_SITE_703
ATAGACCCACATACGGTTTGTGA	ONE_NON-GENE_SITE_704
TTACGTAATACGTCATAGGCATT	ONE_NON-GENE_SITE_705
TACTCGTCCTATGACTTGAGCAC	ONE_NON-GENE_SITE_706
ATGGGTCTAATCTAGTTCACAAT	ONE_NON-GENE_SITE_707
AGGGAGTACCGATTATGTTGTAA	ONE_NON-GENE_SITE_708
TGATGTCAGTATAACATCGATTC	ONE_NON-GENE_SITE_709
TGTATACTTGGTCGAACATAAAA	ONE_NON-GENE_SITE_710
CTCGACTACATATAGAATGTGCT	ONE_NON-GENE_SITE_711
TAATATGTAGGTCCAACCCAAAT	ONE_NON-GENE_SITE_712
ACTAATGGTATAAATCACGAGCT	ONE_NON-GENE_SITE_713
ACTCGAACCACGTTGTCACTTTG	ONE_NON-GENE_SITE_714
GTACACCATAAATCCTCTACAAC	ONE_NON-GENE_SITE_715
CCCTAACGGCATGTAACATGTTC	ONE_NON-GENE_SITE_716
CATATTATGACACAACGTGTTAT	ONE_NON-GENE_SITE_717
GCATGCACGTATGAATCACTGCC	ONE_NON-GENE_SITE_718
GAATCAAGCCTCTAAGGTTTCCT	ONE_NON-GENE_SITE_719
GGTGATCGTAAGTAAGAAACAAT	ONE_NON-GENE_SITE_720
AAACCCGACCATAATCCTCAAAA	ONE_NON-GENE_SITE_721
TATAGGGAGCGACCAGTTCATCT	ONE_NON-GENE_SITE_722
TCCCCTCGTATGACATCAAGGCT	ONE_NON-GENE_SITE_723
GCTGCTCTATAGAAGCTATCTAA	ONE_NON-GENE_SITE_724
GCGGTATTGCACTGACACATGGG	ONE_NON-GENE_SITE_725
CTACTAATACCAAGACACCCATA	ONE_NON-GENE_SITE_726
GATAGTGTATACTGTCCATTATT	ONE_NON-GENE_SITE_727
TGTTCCTACGATGTCAGTCACTA	ONE_NON-GENE_SITE_728
TGGACCCTACTAGAGAACCTTAA	ONE_NON-GENE_SITE_729
GAGCCGTAACACTATGTTGAGCA	ONE_NON-GENE_SITE_730
CGTAATGCACCCAGCATTCTGGT	ONE_NON-GENE_SITE_731
ATACCCGTACTTGGCTTATTTTA	ONE_NON-GENE_SITE_732
AACACGTGTCCCTATTGAAACAC	ONE_NON-GENE_SITE_733
TGGTCCTACTAAGCGCTGAATGG	ONE_NON-GENE_SITE_734
AAACAGAGTCCGGTAGGTTTTAG	ONE_NON-GENE_SITE_735
ATTCTAGGGACTCTCTACCATAG	ONE_NON-GENE_SITE_736
TATGGGAGAATCGTCCCGGCAGC	ONE_NON-GENE_SITE_737
CCCTAAGGGCTGCATAATTTGAG	ONE_NON-GENE_SITE_738
CAATATGCAAGCGGGGAGAAAAT	ONE_NON-GENE_SITE_739
TGTTTATCCCCCGACAACGAAAA	ONE_NON-GENE_SITE_740
CACGATGAACTTACAATTATAAT	ONE_NON-GENE_SITE_741
ATCTCACGTTATGGAGTTCTCTA	ONE_NON-GENE_SITE_742
ATACTAGAGATGTGTACGTTTTT	ONE_NON-GENE_SITE_743
GTTACAGCACTATTATGCTCTGA	ONE_NON-GENE_SITE_744
CGGTATAGAGATTTAATCCTAAT	ONE_NON-GENE_SITE_745
GAGTCCGTGCACTTAGTTATTTG	ONE_NON-GENE_SITE_746
GCTCCTAACCATAAGTTGTAGTG	ONE_NON-GENE_SITE_747
CCACGTCCCGTACTTTACTCTGA	ONE_NON-GENE_SITE_748
TCACTAGCACGTGTTAAATGTCT	ONE_NON-GENE_SITE_749
GATAGCTGGATTACGTGTGTGTG	ONE_NON-GENE_SITE_750
TAAGTACTAGTCCTCATGTTAGC	ONE_NON-GENE_SITE_751
CATGTAGAGTACCAACCCAATCA	ONE_NON-GENE_SITE_752
ACATTCTGCTATAGCCGTCTTGA	ONE_NON-GENE_SITE_753
CTGTTAAATCAGTGGCGGTTATA	ONE_NON-GENE_SITE_754
GTATGAAGGGTAGATATCCAGAA	ONE_NON-GENE_SITE_755
CGTATCTGTATGATACCTATTTT	ONE_NON-GENE_SITE_756
GAGTTGCGTTCCCTAATACAATC	ONE_NON-GENE_SITE_757
GCCAGTAGTCTTAACCTAATTCC	ONE_NON-GENE_SITE_758
AGACAATTCTAGCTGAGCGCGGA	ONE_NON-GENE_SITE_759
GGGGTAAATGTCCCGAGCTCAGC	ONE_NON-GENE_SITE_760
TAATATCCCGAGACTGGGTTGCA	ONE_NON-GENE_SITE_761
TCAAACGTACGAACCATCACTAC	ONE_NON-GENE_SITE_762
TAGGGCTATTAGGGTCCACCAAA	ONE_NON-GENE_SITE_763
ATCAATCTAGTAGGGGTAGAGTG	ONE_NON-GENE_SITE_764
GATACGTCTTAGCCTAGGTTCTT	ONE_NON-GENE_SITE_765
TGAGTCGTGATATAGGAACTTGT	ONE_NON-GENE_SITE_766
TGCTAATTCGTTAGGCAGAGATA	ONE_NON-GENE_SITE_767
GTGAACGAGCCGCCTAAAGGCAG	ONE_NON-GENE_SITE_768
AGGCCGATAATTAGCAATCTTAG	ONE_NON-GENE_SITE_769
CCCACGAACAAACTAATACACAA	ONE_NON-GENE_SITE_770
GGGGTATACTTAGTGTGGAACAT	ONE_NON-GENE_SITE_771
ATTCCGTCTAAGCCACAAAGCTG	ONE_NON-GENE_SITE_772
CACGCTTGACCACTACAGTATGT	ONE_NON-GENE_SITE_773
TACTTCCTATACGAAGGTTCAAT	ONE_NON-GENE_SITE_774
TGTCGCTTAATGGGAACTAAAAT	ONE_NON-GENE_SITE_775
CCAAGTAGCTATTCAATCGTTTT	ONE_NON-GENE_SITE_776
ATCGGTAAGCATTTACTCCTGAC	ONE_NON-GENE_SITE_777
CATGGGTCACCGATGGTAGAACA	ONE_NON-GENE_SITE_778
ACGATGGTAGGGTATTATAGTGA	ONE_NON-GENE_SITE_779
CGACCTACATGTGACAATTTTAA	ONE_NON-GENE_SITE_780
CCGTCGACAGACTTGCTCAGAGT	ONE_NON-GENE_SITE_781
GGGCTTATATCTACCAAGTTATT	ONE_NON-GENE_SITE_782
GAGCTCACGGAGCATACTTGGTC	ONE_NON-GENE_SITE_783
AGTCAGTAGGGGCATGATAGTAG	ONE_NON-GENE_SITE_784
GTTTTGCCTTAACCGAGACTTTC	ONE_NON-GENE_SITE_785
GATACAAGAATACTCGTGACAGT	ONE_NON-GENE_SITE_786
GAGTACCGTGCGTATTGTAAGTA	ONE_NON-GENE_SITE_787
AATGTGGAGTTACGGTGATAAAG	ONE_NON-GENE_SITE_788
CCAGTTAGTAGCAGTACGTTAGC	ONE_NON-GENE_SITE_789
GCATAAGGGTAGATTGGTGTAAC	ONE_NON-GENE_SITE_790
CCTGTCTAAAGTACGGTATGCTT	ONE_NON-GENE_SITE_791
TCTAATTAGGGATACCCCTTTGA	ONE_NON-GENE_SITE_792
ACGAGGTTGAACTACACAAAAAA	ONE_NON-GENE_SITE_793
AAATGATACCCCTATTGGCTTGG	ONE_NON-GENE_SITE_794
GTCGCCATATATGAGAGAGAATA	ONE_NON-GENE_SITE_795
TATACTCTGTACGTAAGTACTTA	ONE_NON-GENE_SITE_796
GCCGATTCATTAGTACTGGAAGC	ONE_NON-GENE_SITE_797
GACGCCAATCGCTTGCCTAAGGA	ONE_NON-GENE_SITE_798
GATTCTTGTTACGTCAGCACTCC	ONE_NON-GENE_SITE_799
AGGTGCGAGAGCGATATTCAGGG	ONE_NON-GENE_SITE_800
TAAGTGGACGGTAACCTACACTT	ONE_NON-GENE_SITE_801
CGTTCCAGAGCCTAATAAGATAA	ONE_NON-GENE_SITE_802
TGGATATGCGCAAGATGTATCTA	ONE_NON-GENE_SITE_803
GTACAGGGGGCAATTTCAATATT	ONE_NON-GENE_SITE_804
CCGTGAATTACCAGATAGAGATC	ONE_NON-GENE_SITE_805
CTAGTCATGAGAGCATGATGTAA	ONE_NON-GENE_SITE_806
ATCACGTATACAGGGCCCTTTTT	ONE_NON-GENE_SITE_807
CTACAGAACGCATTCTCGTTCTG	ONE_NON-GENE_SITE_808
TCTGACCCATGCTAATACCTGAG	ONE_NON-GENE_SITE_809
TAATCCGACTCTCACTGAGTTAT	ONE_NON-GENE_SITE_810
TAGTGTGAACTAGGGCCCATATT	ONE_NON-GENE_SITE_811
GTTAAACGTAGACACAGGATAAA	ONE_NON-GENE_SITE_812
TGATTGACTATACCCTATCCACA	ONE_NON-GENE_SITE_813
GTTAACTGAATTGACCCACTGCT	ONE_NON-GENE_SITE_814
TGAGAATCGCTATAGCTAGAATT	ONE_NON-GENE_SITE_815
AAACCCCTCTGCCGAATGTAAGG	ONE_NON-GENE_SITE_816
TACTAACTAGTAGTGGTCTTTCC	ONE_NON-GENE_SITE_817
CACATACAACCTAAGTGGGGTCC	ONE_NON-GENE_SITE_818
ATTTAGATGCGAGGATCCTCAAC	ONE_NON-GENE_SITE_819
CGTAAATACAAGTAGGTAGCAAT	ONE_NON-GENE_SITE_820
TGTATGTGTGCCGAACCGTTCTT	ONE_NON-GENE_SITE_821
ACCTAATATACTGTACGTCTGTA	ONE_NON-GENE_SITE_822
GTTCGCTATCAGCACATTATTTT	ONE_NON-GENE_SITE_823
CCCCCCTTCTAGTATAATTTACT	ONE_NON-GENE_SITE_824
TACTACGGTGTTCATTGTAGCAT	ONE_NON-GENE_SITE_825
ACACGAACTCGTGTGACATTTAT	ONE_NON-GENE_SITE_826
TCAGCGTATAGAGACCAATGAAT	ONE_NON-GENE_SITE_827
TCGTCACCAGTTGTAAACAGAAA	ONE_NON-GENE_SITE_828
TCGAGTGCCCCACTGTAAAGATG	ONE_NON-GENE_SITE_829
AATCGATCCAATCAACACCAGCA	ONE_NON-GENE_SITE_830
TCGGATCATAATTGATAGATGAC	ONE_NON-GENE_SITE_831
TGAGTATGCTTGGCATAACTGAA	ONE_NON-GENE_SITE_832
ACTGGTGAAAGGTATAGCGGGAT	ONE_NON-GENE_SITE_833
GGGTTCTAAAATCTAGTGCCAAA	ONE_NON-GENE_SITE_834
GGGTTATAGTAGTATCCCAATTT	ONE_NON-GENE_SITE_835
TATAATCACTTAGCTATCGTTGC	ONE_NON-GENE_SITE_836
ACGAGAAACTAGGCATCTAAAAG	ONE_NON-GENE_SITE_837
CCTAGTAAATACTAGGGGTTTTT	ONE_NON-GENE_SITE_838
GATGACCATAGGGTAACCTTGTG	ONE_NON-GENE_SITE_839
CTAACTTGAGTGACCTTACCAAA	ONE_NON-GENE_SITE_840
ACCTCTTGTGATATTCCGCCAAA	ONE_NON-GENE_SITE_841
ATCTGGGTTAACAAACGGCATTT	ONE_NON-GENE_SITE_842
GGTACATATTACATCAGGCTTTT	ONE_NON-GENE_SITE_843
TCGACACATGAGCTTCATTATTA	ONE_NON-GENE_SITE_844
AGTCTATCGTAAACTGGTGATTA	ONE_NON-GENE_SITE_845
AAGGGAGTCACTAGATTACTTTT	ONE_NON-GENE_SITE_846
CTTTAAGGCCACGTCACATCTAG	ONE_NON-GENE_SITE_847
CTATATATGAGCTCCGCCTTCAG	ONE_NON-GENE_SITE_848
CGTGTAAAGTGTCAAAACCAACT	ONE_NON-GENE_SITE_849
GAGTTTCCGACGACATATCTCGA	ONE_NON-GENE_SITE_850
TGGTAGGAGCATTATTAGCAGTT	ONE_NON-GENE_SITE_851
GTGGCGGTAAATTCCAACCTTCT	ONE_NON-GENE_SITE_852
AGCCTGTACCGATGGCATACTGA	ONE_NON-GENE_SITE_853
CGTAGGATAACGATTCATTTTCT	ONE_NON-GENE_SITE_854
CGCCATTATAGTGCATACAGAAT	ONE_NON-GENE_SITE_855
TGGTGTGTCGTATTAGATTTAGT	ONE_NON-GENE_SITE_856
AATAGATAGCGATAGTTTCTGTA	ONE_NON-GENE_SITE_857
GCAGTGGACGTCTACATAGTGGC	ONE_NON-GENE_SITE_858
CTGATGCTCTACTAAATCGTCTC	ONE_NON-GENE_SITE_859
CGATCCTGAGTAAACCATTATAT	ONE_NON-GENE_SITE_860
GAATTACTTACGCACACATACAC	ONE_NON-GENE_SITE_861
GCTGATAATGTTTAGCGTGTTAG	ONE_NON-GENE_SITE_862
CAATCAATTGAGAGGACGTAGTA	ONE_NON-GENE_SITE_863
AGATGATCCGCTTTGGACCTGGT	ONE_NON-GENE_SITE_864
AAAGAGATCTCGTTCAACCCCCC	ONE_NON-GENE_SITE_865
CATATAGGATATAACCCCCCATA	ONE_NON-GENE_SITE_866
GGGGATTAATAGTCACTTATCTC	ONE_NON-GENE_SITE_867
GTCGATTGCACAAGTCTTTATTA	ONE_NON-GENE_SITE_868
AGATCTGGCGAAACTATGTGTGA	ONE_NON-GENE_SITE_869
ATCCTGTAAGAACGTCGGTTCTC	ONE_NON-GENE_SITE_870
ATTGAAGACTCCTAGGGTACAGT	ONE_NON-GENE_SITE_871
TACGGAGCCCTTAGATTTATTTC	ONE_NON-GENE_SITE_872
CGTATGCATAATAAGTTGCCTTA	ONE_NON-GENE_SITE_873
ATCATAACAACTCTCGCTCCAAA	ONE_NON-GENE_SITE_874
ACACACGTTAGTCTAGCATCAGT	ONE_NON-GENE_SITE_875
TCGTAACAGGTTAGATACATATT	ONE_NON-GENE_SITE_876
CATTGGGATGGGCGATTGTCCTG	ONE_NON-GENE_SITE_877
GTTGCCCCAAGTACTTCGCTTAA	ONE_NON-GENE_SITE_878
ACATGGTAGTCCCAGTATATCCC	ONE_NON-GENE_SITE_879
ACCACAGACTCGTAATATGGACC	ONE_NON-GENE_SITE_880
GTCATGTAAACTAAGTACCTAAT	ONE_NON-GENE_SITE_881
TAACTACTGAGCAATACGTCTAT	ONE_NON-GENE_SITE_882
AATGAGTCTAGCAAACGGTTCAA	ONE_NON-GENE_SITE_883
AATACGGACTAGTAAATAGCAGA	ONE_NON-GENE_SITE_884
ACCCGAATCTAATCGGAGGAAAT	ONE_NON-GENE_SITE_885
GTGTCCCACATCTGATAACTGGG	ONE_NON-GENE_SITE_886
GACGGTCCGGGTTGATTCATGGC	ONE_NON-GENE_SITE_887
AGCGCTTGCTTACTAACCCAATG	ONE_NON-GENE_SITE_888
GAGTACTAGGCATGACCAAACAT	ONE_NON-GENE_SITE_889
GTGGGTGATTCGGTCCCTTCCTG	ONE_NON-GENE_SITE_890
GTTCTCACGTAACTTTACAAGGT	ONE_NON-GENE_SITE_891
TGTCATAGGCACGTGAGACACTG	ONE_NON-GENE_SITE_892
GAGTAGACCTATACATAGGAAAA	ONE_NON-GENE_SITE_893
AGTCCGTCCCTGAACATTAATGT	ONE_NON-GENE_SITE_894
TCCCTTGCGATACTAACCAACCA	ONE_NON-GENE_SITE_895
AGGTACGAATTACCAAGGGAAAG	ONE_NON-GENE_SITE_896
ATGTATAACCGTGAATTGCCAGA	ONE_NON-GENE_SITE_897
CAACACGTGATAAGGTTGCACTT	ONE_NON-GENE_SITE_898
CCCTAATAATACTCAAACCTGCT	ONE_NON-GENE_SITE_899
TATGACCCCTAGCATGCAATTAG	ONE_NON-GENE_SITE_900
TGCGGTTCCTAGTGTCGCCAAGC	ONE_NON-GENE_SITE_901
ATTGTTACCAAGGGACGGTCCAA	ONE_NON-GENE_SITE_902
GGAATCATGAGCGTGCAATGTTT	ONE_NON-GENE_SITE_903
TATGGGAGCTTAAGTTAGCCAGG	ONE_NON-GENE_SITE_904
CCGAATGATCACGTTACCCACAA	ONE_NON-GENE_SITE_905
CATTATAGCACACTATCCCTTAT	ONE_NON-GENE_SITE_906
CCCGTGTTGTTAACAGCTGTGAA	ONE_NON-GENE_SITE_907
GGGTAGGTGCTTATTATACACAA	ONE_NON-GENE_SITE_908
ATAGTAGTTAGGTGTTCTAAGAT	ONE_NON-GENE_SITE_909
ATGTCACGCTCCCTTTAAGCAAG	ONE_NON-GENE_SITE_910
AGTTTCAGACCCGATATTACTTG	ONE_NON-GENE_SITE_911
CGGTACTCATGCATAATGTTTTT	ONE_NON-GENE_SITE_912
GCAGTATAACACTATGAGCTCAT	ONE_NON-GENE_SITE_913
ACGGTTTCACCAACTGACTTATA	ONE_NON-GENE_SITE_914
TATAGGGAGATCAACGCTAATGA	ONE_NON-GENE_SITE_915
ATACGTGCAAACCCATGCCCTTG	ONE_NON-GENE_SITE_916
AGTGACGGACGGGTGTAGTTGTA	ONE_NON-GENE_SITE_917
TCTGTCCTAATAGCGATAATAAC	ONE_NON-GENE_SITE_918
CCTTCTTACGTTAGGCACTCCTT	ONE_NON-GENE_SITE_919
ACGGCAGTACAGTACTCTATTCT	ONE_NON-GENE_SITE_920
TCACTAAGTATGCACCACCTGAA	ONE_NON-GENE_SITE_921
CCCAAATTGTACGAGATTGGATG	ONE_NON-GENE_SITE_922
GTTCAAGCTCGTGTCTATTGACA	ONE_NON-GENE_SITE_923
TATTGGTCTATCGTACTCCATTT	ONE_NON-GENE_SITE_924
GTAGAATGGGCCCGACTCTATGT	ONE_NON-GENE_SITE_925
GTCGTGATTGGAGAGCATACTTT	ONE_NON-GENE_SITE_926
GAATGTGCGTAGAACTCTGGCAG	ONE_NON-GENE_SITE_927
TATAAGAACGAGTAAGGTCAATA	ONE_NON-GENE_SITE_928
TGTCTACCTCGCCTCTAAACATA	ONE_NON-GENE_SITE_929
GGTAACCCCCTAAACTAGAACTG	ONE_NON-GENE_SITE_930
GTCAACCAGACGTATACAGGTTA	ONE_NON-GENE_SITE_931
TAGGCTCCTAACCATATTGGTTA	ONE_NON-GENE_SITE_932
CGTAGAATCGATATTATATTTTC	ONE_NON-GENE_SITE_933
CATATATTCTAGCGCACATCTTT	ONE_NON-GENE_SITE_934
GTTCTTGATCCACCCTAATTACA	ONE_NON-GENE_SITE_935
CATGTAGGCCCTATGATCAAATT	ONE_NON-GENE_SITE_936
GGCTACTGGCAAATAGTACTACC	ONE_NON-GENE_SITE_937
TTAGGTAACACGCGCAGAACTGT	ONE_NON-GENE_SITE_938
ACTCACTATTACGTGGCATTAAG	ONE_NON-GENE_SITE_939
GACCTATGCAAGCTAGTAAAAGA	ONE_NON-GENE_SITE_940
ACGCCACCTTAAATCCAGGATGA	ONE_NON-GENE_SITE_941
CGTAGATAAGAGCGCCAAAATAA	ONE_NON-GENE_SITE_942
CCTCACTTAGCGAAAGCATTTCT	ONE_NON-GENE_SITE_943
GCATCTTATTAGCCGTAGGTTTA	ONE_NON-GENE_SITE_944
GCAAGAAACCACGTAGATTTAAA	ONE_NON-GENE_SITE_945
ATACGGGAGTAATACGTGTCAAA	ONE_NON-GENE_SITE_946
ACTACTATGCTAGGTGACTCATA	ONE_NON-GENE_SITE_947
ACATCGGAGTAATATAGGAGGAT	ONE_NON-GENE_SITE_948
TTGGATCTATAACTGACGAGAGA	ONE_NON-GENE_SITE_949
GGTGGAGCGATAGTGCAAGTATA	ONE_NON-GENE_SITE_950
GTACTTTGACCCTAGAGTGTTTT	ONE_NON-GENE_SITE_951
AGCGTTTCTAAACATGCGATTTA	ONE_NON-GENE_SITE_952
GGGTGCTAGTTACATGCGTGTCA	ONE_NON-GENE_SITE_953
ATTATGACTGGTCGAGCATATTG	ONE_NON-GENE_SITE_954
TTGTCCCGTAATATCTCCTCTCT	ONE_NON-GENE_SITE_955
AAACCTAGAATCGTGCAATACAT	ONE_NON-GENE_SITE_956
AATAGGGCCTGAACCAGTAGTCT	ONE_NON-GENE_SITE_957
GGGGTGCTTGGTATAATGAGTTT	ONE_NON-GENE_SITE_958
AGAGAATATACGCTACTGCCGTC	ONE_NON-GENE_SITE_959
GCCCATATATAGGTGATACCCAT	ONE_NON-GENE_SITE_960
AACTACCGCATACTAGCAACAAT	ONE_NON-GENE_SITE_961
CCTCGTAAGTTGTAGCTAAATAT	ONE_NON-GENE_SITE_962
CGTGTGATCACTAGAAATATTGA	ONE_NON-GENE_SITE_963
CGATAAGTGGATGACTAGCGGTC	ONE_NON-GENE_SITE_964
AACGGCAAGCTATGTTGTGAATA	ONE_NON-GENE_SITE_965
AAGACTCTATCGTCCAAGCTGGA	ONE_NON-GENE_SITE_966
CACGAGTCAAACGAATTATATGT	ONE_NON-GENE_SITE_967
GTAACCTCCTAAACTAGGTAGGA	ONE_NON-GENE_SITE_968
CCGAAGGTAACCACTATGCAGAT	ONE_NON-GENE_SITE_969
CTAATCGCCAACCCAACCTTTCC	ONE_NON-GENE_SITE_970
AGCACACGAGGTGGGGTAAACTG	ONE_NON-GENE_SITE_971
AAATCAGGCGAAGGTTAGTATTT	ONE_NON-GENE_SITE_972
GGAGTGTACTCCGGATTAGGTAA	ONE_NON-GENE_SITE_973
AGTCCCTGTAACGTATGATTTTG	ONE_NON-GENE_SITE_974
ACTATTAATCATAAGCGATCACT	ONE_NON-GENE_SITE_975
CCGTAATCATTAATGCACTATAG	ONE_NON-GENE_SITE_976
CTCTTACGAATGGGACACCTATG	ONE_NON-GENE_SITE_977
ATTATAAACGCTCATTCCCTGAC	ONE_NON-GENE_SITE_978
GAATCAGTATAATAGCGTGTGTA	ONE_NON-GENE_SITE_979
CGCTACATGGATATAACGGTAGT	ONE_NON-GENE_SITE_980
AAGAACTCCCCGACACGATTTTC	ONE_NON-GENE_SITE_981
GCAGTATTACTTAACTACCACCT	ONE_NON-GENE_SITE_982
TCCCCCGACAACGAAAACCTTGA	ONE_NON-GENE_SITE_983
CTAGGGATATTTCCCGTCCTGGA	ONE_NON-GENE_SITE_984
GGTCTTATAGAGTGGACTAAATT	ONE_NON-GENE_SITE_985
CTACGTCGTGATTTAATCTACCA	ONE_NON-GENE_SITE_986
CCTATTGCCTGCAATCGCTTCTG	ONE_NON-GENE_SITE_987
TCCCACCTAGAACCTAGACATTA	ONE_NON-GENE_SITE_988
CGTACCAAAAGCTCATAACGTAG	ONE_NON-GENE_SITE_989
AGGACTAGCATAGACTAGACTTT	ONE_NON-GENE_SITE_990
CCCCCCATTAGCTTGCTAACTAA	ONE_NON-GENE_SITE_991
TTGTGAGTATCCATCTACGTCTT	ONE_NON-GENE_SITE_992
CAATGTGTTACCCTCCCTAGATT	ONE_NON-GENE_SITE_993
AGCCTCGAACTGTTACCGAGTTC	ONE_NON-GENE_SITE_994
TGACGAACACTCAATACAGCCCA	ONE_NON-GENE_SITE_995
ATTAGGTAAGCGTTTGATGAGTT	ONE_NON-GENE_SITE_996
GGGGTATCAGATATTAGCCCCTG	ONE_NON-GENE_SITE_997
CTACACCCTAACGTATGACATAT	ONE_NON-GENE_SITE_998
AATATCTACGGCTTGTACGGAGA	ONE_NON-GENE_SITE_999
ATAGCATGCCAAATTTCGGATAG	ONE_NON-GENE_SITE_1000